sentence	label
Belum balik dana refund serbu seru saya	transaksi
Pesanan saya dari kemarin belum di pick up gojek sameday kenapa ya min??	transaksi
Tiket #10085613 [Bukalapak] Konfirmasi Transaksi 181527127469  sampai kapan komplen nya selesai?? Slow respon dan ga ada penjelasan	transaksi
@appodi_haruok cek saldo buka emas dimn ya.? kok apl BL saya gak ada ya.? Ada nya bukadompet, DANA dan Credit.	produk
Saya hub BL sllu sibuk CS nya , tlg bntuannya BL19128RDFZWINV <enter> Tgihan sudah saya bayar sdh 4 jam yg lalu tp msi stts masi menunggu pmbayarn tlg infonya	transaksi
191714906666 pembeli sudah setuju	transaksi
Hallo @bukalapak berhubung saya sudah kecewa dengan apa yang terjadi dengan Serbu Seru mulai hari ini dan selamanya saya tidak akan ikut Serbuan yang nggak tau palsu apa asli ini. Ratusan kali saya ikut dan sekali dikecewakan karena dan 12.000 dianggap sebagai modal buka emas tanpa pemberitahuan sebelumnya membuat saya sadar bahwa Program Serbu Seru adalah program Bukalapak yang bagi saya tidak benar2 ada.. terima kasih sudah pelanggan mu amat sangat kecewa..buat yang lain yang masih tergiur dengan program Serbu Seru silahkan ikuti dengan senang dan yakin... terima kasih Bukalapak semoga tidak terjadi pada yang lain..	misuh
@sammygepe sudah tahu bro😒 b aja kali gak usah so pinter gitu	lainnya
Perhatikan jawaban dan pertanyaannya :D	lainnya
Pas tau saya gagal lagi dapetin emas, saya cukup tepukul😭	misuh
Min DANA saya ada yg belum balik kok ya kemarin @bukalapak akun bandararloji	transaksi
Min, kok dana saya blum dibalikin sampai sekrang pas ikutan serbu seru udh sehari lebih min	transaksi
@bukalapak min tlg dibuka DM nya.. saya mengalami kendala.. terima kasih..	servis
Hayo siapa yang nyesel milih emas di serbu seru😂	misuh
Yg udh pernah menang serbu coba ceritakan disini....	lainnya
@yogathul pending ?	transaksi
191714906666 mohon dibantu aktifkan saya mau kirim.mksh banyak	transaksi
Untuk no teransaksi: 191707438801 kapan yang saya masuk ke dompet?... Dan untuk serbu 190880437376 knpa uang saya di kembalikan hanya 39perak?...	transaksi
Pantes saldo gk balik gmn mo ikutan srbu seru lgi.. Payah	misuh
Nembak siapa yaa ? Hahaha bingung min. Kemarin udh nyaman dengan hati yang amat baik min, tapi di sia siain,.,., eeh gak taunya aku ingt lagi.. Kasihan yaa min 😂😂	lainnya
@sammygepe Gimana sih caranya liat saldo buka emasnya?? tolong dibantu gan, saya baru di Bukalapak	produk
Di kamus saja tak ada hari valentine min karena hari kasih sayang bagiku itu setiap hari dan sepanjang waktu😁 seperti sayangnya saya ke @bukalapak meskipun ikutan #serbuseru meleset terus tapi saya selalu semangat untuk terus ikutan karena rezeki itu ga akan jauh kemana. #bukalapakuntukindonesia #bukalapak	lainnya
Udah 2x24 jam saldo buka emas twtep 0 gak jelas nih @bukalapak	transaksi
Ikut serbu seru 2 hri gk kembali danaku meleset juga ada apa ini min	transaksi
@bukalapak tolong bls dm dong ka	servis
@roma_ilas ane jual td mlm 12.480	lainnya
@muhammadmadani3 nominalnya akan berbeda	lainnya
@roma_ilas kan bisa di jual lagi, balik ke buka dompet saldo nya	lainnya
Nembak versikuh adalah konsisten dengan apa yg kita perjuangin.  Punya gebetan jangan didiemin,  pas valentin gini momen pas buat kasih cincin.  Tanda pas buat lamar kawin.  Klo pun ditolak jgn dipikirin toh ada lagi jodoh yg lain @bukalapak  #BukalapakUntukIndonesia	lainnya
Kenapa sih, uang serbu seru bukalapak jika tidak menang. Uangnya dijadikan investasi buka emas tanpa persetujuan dari kita. Itu sama saja penipuan. Mengambil hak orang lain. Saya kecewa dengan tindakan ini. @bukalapak	misuh
@sammygepe ya tw tp buat jual aja ga bs balik uangna, trs ad yg blm balik lg saldo ke emasnya msh 59 rupiah tongggg!	misuh
@avip_lovato iyaa 😂 jadi rugi kita, biar kita nahan lebih banyak invest an lagi ke bukalapak.. Soalnya kalo lebih banyak invest mereka lebih banyak dpet % an juga dri bank2 😅😅	misuh
Mohon penjelasanya...	lainnya
Boleh bertanya ...	lainnya
Pagi admin Bukalapak...	lainnya
@_bayuwibowo djualpun hsilnya dbwh 12rb😁	lainnya
Kamu adalah bagian dari tulang rusuku dan akan sempurna jika bersama ku.@bukalapak	lainnya
@yogathul pihak bukalapak minta kita nahan dana invest ke buka emas bro 😂 jangan jual dulu, rate penjualan terus menurun jadi kita rugi kalo jual sekarang, permainan bukalapak ini wkkwkwkwk	misuh
Knpa jual emas selalu gagal -_-	transaksi
@sammygepe mu tanya ikur serbu bayar pake virtual account dana refundnya ke bukadompet apa jadi credits?	produk
Dunia ku terasa indah melihat dia cantik dan ku ingin memiliki dia namun diriku terasa sulit untuk mendapatkan dia , karena ku yakin ku bisa dengan cara pengenalanku lama kelamaan aku tersadar bahwa dia cocok buat diriku ini, aku sangat merasa yakin untuk mendapatkan dirinya hingga aku akhirnya mendapatkan cinta dia dengan cara ucapan ku yang membuat dia tertarik kepadaku , cinta memang harus di perjuangkan bukan untuk di lepaskan	lainnya
👆	lainnya
Kalau versi nembaknya untuk Bukalapak boleh ga yaaa...😂 #BukalapakUntukIndonesia	lainnya
berkali-kali gue tembak eh mleset terus akhirnya gue serbu ehhh masijuga mleset mleset terus 😢😢😢 kapanya ketrimanya dan tulisanya berubah menjadi TERPILIH #BukalapakUntukIndonesia	lainnya
@b.ynfrsk kok pas yaa	lainnya
Kalau aku nembaknya pakai surat kecil min, isi nya gini.. "Dia bilang dia tidak rupawan dan bukan dambaan, walau begitu, hanya kehadirannya yg dapat membuatku tenggelam dan nyaman.  <enter> Dia bilang, dia tidak sekuat yang ku kira, seringkali punggung tegak dan senyuman yang ia tunjukkan palsu belaka, walau begitu, yang ku tahu adalah langkah yang tetap ia jejak meskipun hatinya retak lalu patah.  <enter> Dia bilang, dia sibuk dan tak punya waktu, walau begitu, yg kurasa adalah genggaman tangannya yg menarikku untuk tetap menyatu.  <enter> Dia bilang dia jauh dari kata sempurna, walau begitu, yg ku butuh adalah dia dan hanya dia karna dia lebih dari sempurna untuk ku.  <enter> Tolong sampaikan padanya ya, iya dia yg lagi baca.  <enter> Sampaikan kepadanya, bahwa aku menyayangi nya." <enter> Besoknya di terima deh, hehehhe.. #BukalapakUntukIndonesia	lainnya
@catsgrowup wtf	lainnya
@catsgrowup wkwk sama	lainnya
dear cintaku.... dihari yg penuh kasih sayang ini saya hanya ingin mengucapkan sesuatu hal pada mu. kalau kau mencari yg lebih tampan dari ku, di luar sana banyak yg lebih tampan dari ku. kalau kau ingin mendapatkan yg lebih kaya dan lebih mapan dari ku, di luar sana banyak yg lebih dr itu dr pd aku. tapi cobalah cari yg lebih setia, lebih pengertian dr aku, dan lebih memahami kamu selain aku. mungkin tidak ada selain aku... selamat hari valentine..#BukalapakUntukIndonesia	lainnya
cinta sejati adalah cinta yang tidal berasal dari hawa nafsu,tapi tulus untuk melindungin orang yang kita sayangin @bukalapak #bukalapakuntukindonesia	lainnya
cinta tak pandang dari rupa,dan pemberian tapi dari hati yang tulus tanpa memandang yang lain @bukalapak #bukalapakuntukindonesia	lainnya
@appodi_haruok oke terima kasih mas,sekarang udah ngerti.	lainnya
@sammygepe barusan cek juga ga ada, gimana dah	lainnya
@catsgrowup sama.	lainnya
@alfareall.jss anjay 50kg hahahaha😁😁😁	lainnya
@sammygepe makasih tong, baru aja mau nanya	lainnya
Jangan kan sebatang coklat buat ngasih hadiah Valentine ke kamu, Pohon coklat pun akan ku Tebang demi bahagiain Cinta dari mu, wahai bidadari ku 😍 @bukalapak #bukalapakuntukindonesia	lainnya
@appodi_haruok oke skrng sya paham🔥	lainnya
Yaaaa blm apa2 udah kepleset, sakit min kepleset trus 😆😆😆	lainnya
@appodi_haruok terima kaaih bro 🙏🙏🙏	lainnya
Ada gak sih yg asli dapet hadiah dr serbu ?🤔 Klo saya amati yg dapet kok orang nya itu2 mulu.	misuh
@luthfyalfy buka saja dm yang saya kirim seperti itu tampilanya	servis
@luthfyalfy nih saya kirim dm capturenya	servis
@luthfyalfy pasti tau kita meleset bro,tinggal buka gambar yang ada dian sastro spesial 2.2,nanti kelihatan riwayat yang kita beli tinggal lihat saja produk yang kita beli diserbu,meleset terus,nama pemenangnya ada di situ tapi gak tau asli atau fiktif soalnya akun pemenang2nya gak ada yang bisa dibuka	misuh
@appodi_haruok nah iya, apalagi kalau digantung kita menang atau engga, sakit tau😂😅	misuh
@yoanovan tipikal org indo.. kagak baca aturan main/s&k.. main sikaat aja.. giliran gadapet pada berkoar protes 🤣🤣🤣	lainnya
@luthfyalfy kalau melihat itu gak tau bro,sya juga meleset sudah 500 x lebih 😂😂,soalnya kalau buka akun pemenangnya gak bisa kebuka	misuh
@appodi_haruok kalo mau liat para pemenang hadiah dari serbu seru dimana sih	produk
@sammygepe mas, pengumuman serbu seru selain hadiah emas dimana sih,	produk
@puspadwinovianti buka saldo emas,tekan beli lagi,pilih jual lagi sekitar 0.021 gram	lainnya
@appodi_haruok ko di saya gk ada fitur jual ya? Dr kmrn bingung sendiri,tadi jg saldonya ke potong lagi.	produk
Tulisannya udah meleset semua warna kuning, tinggal diganti warna pink 😂	lainnya
Cek cek riwayat ,gak ada babibu 21transaksi meleset lngsung smuanya ,,mkin gaje nih bl	misuh
13 meleset semua	misuh
@sammygepe nambahin skalian udah pada baca blm refundnya ke buka emas max 2x24jam brrti bru ntar dini hri masuknya	lainnya
Jomblo min gmn mau menyatakan perasaan 😂😂😅 #bukalapakuntukindonesia	lainnya
@mrdzikri kalau saya ada mungkin kamu gak tau bukanya bro,buka saldo emas,ada yombol beli lagi,pencet saja,terus geser sampai kelihatan investmu,terus jual kalau dah laku kembali kesaldo uang	produk
@dyofhany_gummy karna belum kamu buka sampai ke beli nanti ada fitur jual,buka saja saldo emas,nanti pilih jual saja lagi naik 7 %	produk
@alfareall.jss 50 gr	lainnya
@ichsanex saya baca. Tapi pas cek saldo bukaemas tetap 0. Saya udah coba blanja emas sekalian liat apa saldonya ke-hide. Pas mo bayar ga ada pengurangan dr saldo bukaemas 😂	produk
Kata orang2 besok hari kasih sayang tapi bagi ku setiap hari adalah hari kasih sayang didalam rumah tangga kita cie cie 😂😂 @andreasboyfernando #BukalapakUntukIndonesia	lainnya
@sammygepe saldo buka emasnya 0. Nyasar ke akun mana tuh refundnya?	transaksi
@dede_wahyu27 oh	lainnya
kamu tau ga @ameliya_sari19 besok itu tgl 14 februari kata org hari kasih sayang , kata tetangga aku juga ia , kata temen nya mamah aku jga sama , dan temen bapaku juga bilang gitu , dan temen nya temen bapaku jga bilang gtu, sama kaya temen nya mamahku dan tetangga nya mamahku dia bilang gtu jga , walaupun temen nya bapaku bilang gtu tapi temenya ibuku bilang gtu juga ko , kamu tau kan , ....	lainnya
Ngomongin soal nembak jd igt kisahku min. Cerita dikit y cara mantan pacarku dulu 'nembak' ak. Setelah 2x gagal nembak alias kutolak, ga bikin doi menyerah. Nembak ketiga doi bilang ' pokoknya diterima ga diterima km udh ak anggep pacar' wahhh bingung bgt waktu itu, secara dia lebih tua 7thn, dia tmn bos tempat ak krja partime'an jmn kuliah. Bingung mikir gmn lg caranya nolak yg alus. Akhirny ngasal aja krn udh mentok ak ajakin suit aj,kl doi menang jadian, kl kalah blm jodoh. Eh trnyt doi menang 😂. Ak alesan lg ga boleh pacaran sm ortu, doiny langsung k rumah minta izin langsung k bokap yg super killer. Singkat cerita 3 thn pacaran dari akunya yg tanpa rasa sampe akhirnya mau jg . Mg bs menginspirasi 😅	lainnya
@asepnurdin20 yg dapet emas nya juga gak jelas siapa @bukalapak udh man saldo gi di balikin 😢	misuh
@mrdzikri sama senasib bro	misuh
Besok hari valentine,nikah yoook #bukalapakuntukindonesia	lainnya
@appodi_haruok emasnya juga blum balik bro, gmana tu ? msh 0 gram	produk
Setelah semua yang kau berikan selama ini, rasanya terlalu pelit jika aku tidak mengucapkan kata cinta padamu. Selamat hari valentine #bukalapakuntukindonesia	lainnya
Akhirnya aku menemukanmu untuk bilang "i miss u"  <enter> setelah kalimat Ampuh itu tertahan sekian lama untuk diUcapkan bibirku & tertahan cukup lama untuk ditulis oleh jariku 😍 <enter> Aku buang Gengsiku hanya untuk Bilang " I MISS U " , walau sekarang kita terpisah oleh Pulau, aku di Jakarta & kamu di Palu, aku yakin suatu hari nanti kita akan bertemu diPelaminan 😆  <enter> karena hanya kamu yang bisa mengobati luka hatiku yang terluka beberapa tahun silam <enter> Yuk ikutan sahabat @edbert.ivander @fransisca.fortunata @etania.cassandra123 follow @bukalapak #BukalapakUntukIndonesia	lainnya
Disini banyak yg komplain ya tapi ga ngikuti instruksi dgn seksama, obsesi hadiah tp ga mau rugi astaga 😂😂😂 ber-flower oh ber-flower 😁.	lainnya
Nembak versi aku <enter> Sayang Tahun ini usiamu tepat 25 Tahun, tepat dihari Valentine aku kasih kamu baju Gamis warna putih biar semakin rajin Ke Masjid untuk: <enter> I = Ingat Sholat 5 waktu & Sholat Jum'at <enter> B = Berdoa, beramal & bersyukur <enter> A = Aku & kamu, Lamaran & Menikah tahun ini <enter> D = Ditabung uangnya, untuk masa depan <enter> A = Allah menjawab DOA & Ikhitiar kita <enter> H = Halal tujuan bahagia kita tahun ini, InsyaAllah Amin <enter> Tercinta:  <enter> Dari coklat1802 untuk keju2609 ❤ <enter> #BukalapakUntukIndonesia	lainnya
CINTA singkatan dari CILEUH DINA MATA	lainnya
Dengan cara tidak biasa di jaman sekarang.yaitu mengirimkan surat berisi kata-kata ungkapan dari hati , & itu t pernah gagal buat dia semakin sayang. #BukalapakUntukIndonesia	lainnya
Bukalapak menjual bakul <enter> Bakulnya terbuat dari jerami  <enter> You are so beautiful <enter> Will you be mine?  <enter> #BukalapakUntukIndonesia	lainnya
Testimoni yg dapet emas  krmaren ada gk y orang nya, please share yg yg ketiban emas 50 kg😂😂 pingsan gk  y pas diumumin dapet😮	misuh
@sammygepe dipostingan sebelumnya banyak yg ngeluh wkwk 😅masih banyak yg malas membaca ternyata 😂	lainnya
Dengan cara bilang aja sejujur nya bahwa kita suka sama orang yang lagi Deket saat ini. Urusan ditolak belakangan, karena abis mengungkapkan perasaan kita juga butuh sebuah jawaban supaya tidak penasaran dan juga tidak digantung perasaaan nya. #BukalapakUntukIndonesia	lainnya
@appodi_haruok Emas nya juga ga ada, makanya bingung	produk
brang saya tidak sampai2 dari tanggal 22 januari sampai sekarang tanggal 14 februari,  tiap di tanya selalu ksih info yg tidak falid dan berbelit2 , tolong kerja sama nya min,  sudah lama kali ini . Saya butuh kejelasan dan titik terang masalah paket saya,  sudah 2 mnggu anda slalu blng lagi di investigasi oleh tim terkait. Id resi BLAPK191637604839	transaksi
hai @bukalapak makin hari tambah sukses aja ehehhe	lainnya
Nawarnya iseng2 aja sih... kan sebelum nya search harga di marketplace. Jadi kalo harga jual barang yg mau dibeli sama dgn harga di markrtplace ya ga di tawar..	lainnya
Menawar versi aku yaa... dari 50% hingga 90% Min ,kalau masih tetap ga boleh yaaa bye...bye...bye...😂 #BukalapakUntukIndonesia	lainnya
Kemaren saya beli kamera sony a7ii dari harga 11,5 juta aku tawar jadi 11 juta, lalu ternyata uang saya kurang 500rb, akhirnya penjual saya goda akhirnya dia mau kalo saya bayar 10,5jt juta dulu, 500 rbnya minggu depan wkwkwk	lainnya
@dewi_sandi_1516 saldo buka emas jadi Rp 15.615, trs ini buat apaan. Huft	misuh
Makannya jangan di serbuin min , jdi habis weh emasnya 😁😝	lainnya
Pernah beli handphone dengan harga 1.2 jt di tawar jadi 1,1 jt 👏👏👏 #BukalapakUntukIndonesia	lainnya
Beli box bayi creative harga asli 715.000 aku nego jadi 650.000 ehh gak bisa kejauhan sampai mentok nett 700.000.. kan lumayan diskon 15.000..terimakasih Bukalapak,, InsyaAllah kali ini aku bisa nego jg di serbu seru ya..aamiin#adibahalamudi#batu permatakik#bukalapakuntukIndonesia	lainnya
@andrejstmrg sampai kiamat juga gak bakal balik,kalau emasnya gak dijual 😂😂	produk
@dewi_sandi_1516 ya gak bakal kembali ke saldo,kalau tidak jual emasnya 😂😂	produk
aku tuh gak neko2 minta saldo balik atau gimana. yg penting bisa dapet laptop seharga 12ribu:( biar gak bebanin ibu kudu beliin baru :( macbook atau apapun itu deh:(	lainnya
Saya waktu nawar mahar istri saya dari 100jt jadi 10jt	lainnya
@dewi_sandi_1516 maksumal 2x24, ini belom sampe sehari dah pada ribut	lainnya
mungkin Emasnya abis 😂 lagi nyari di tambang dulu 😆	lainnya
🔥😢😁👏	lainnya
@dewi_sandi_1516 kmren kn ad notif ny lgi ad mentenen kk... jd d tnggu aj kk  <enter> Krna w jga blom bliak jga 12k ny <enter> Heeeee	produk
@bukalapak tapi blum kembali ke dompet gan	produk
@dewi_sandi_1516 Hai, perihal pengembalian Serbu Seru BukaEmas kamu, apabila kamu belum terpilih untuk serbu seru BukaEmas, maka kamu akan menerima pengembalian uang dalam bentuk saldo BukaEmas yang akan diterima dalam waktu maksimal 2x24 jam, ya.	produk
Saya jg gara2 ikutan serbu buka emas tapi saldo saya tidak kembali lagi pdahal kan dstu tercantum bahwa kalau tdk menang bakal kembali noh duit tpi ternyata kagakk nyesell dehh gua	misuh
@andrejstmrg Hai, perihal pengembalian Serbu Seru BukaEmas kamu, apabila kamu belum terpilih untuk serbu seru BukaEmas, maka kamu akan menerima pengembalian uang dalam bentuk saldo BukaEmas yang akan diterima dalam waktu maksimal 2x24 jam, ya.	produk
Teryta byk m	lainnya
@rajangiler mending gk nego tp pake voucher potong ongkir 20rb,, soalnya klo nego gk bs pake potongan ongkir,,, wkwkwk	produk
@muntaha_7177 lumayan kan daripada ga sama sekali😂	lainnya
Saya biasanya suka nawar dari setengah harga. Klo g dapat paling naikin dikit2 sampai deal 😊	lainnya
Biasa nya si kalo nawar palingan setengah harga dari harga jual kekkekekkek	lainnya
Maaf sebelumnya ya,saya juga saldonya ngak balik tapi saya ikhlasin aja itung itung udah diperolehkan buat nyerbu,coba kalau kita tak bisa ikutan buat nyerbu,lagi pula hanya 12rb dalam ratusan kali serbu.sukses dan sehat selalu buat para penyerbu #BukalapakUntukIndonesia #mitrabukalapak	produk
Paling beda 10 rb dr harga yang ditetapkan #mitrabukalapak #BukalapakUntukIndonesia	lainnya
Beautiful @bukalapak	lainnya
Paling banter di app cuman bisa kurang 5000, Kalo beli asli sih gapernah nawar, suka ga enak sama penjualnya.🤣🤣 #BukaLapakUntukIndonesia	lainnya
sabar dalam menawar	lainnya
barang 200rb an nego turunnya paling 5rb.... bs nembus 10rb ajh udh hebaaaat bgt.... hhhh	lainnya
Assalamualaikum ka, ijin pantun yah🙌. Ke jogja beli nangka, wall decornya kaka💕	lainnya
#BukalapakUntukIndonesia beli reciver digital harga 300 ribu ditawar menjadi 250 ribu	lainnya
@bukalapak min mau tanya, saldo buka emas itu ngeceknya di aplikasi bukalapak dibagian mananya? Saya tdk tau.trima kasih	produk
Min @bukalapak  aku dpt notife serbu bukaEmas, gmna selanjutnya mohon bantuanya terimakasih 🙂	produk
Check dm kak ada hal penting	servis
Baca DM MIN KENAPA DANA SAYA HILANG MAIN SERBA12 ITU	servis
Riwayatku panjangnya 2 meter tulisannya meleset semua... @bukalapak DM dong gmn caranya go meleset la..	servis
400x meleset,  akhirnya duit refund blm kembali 12rb nya.  Udh jatuh ketimpak tangga.  Apakah ada yg sama dgn saya?	misuh
jngn harap dpt serbu seru klo bukan pelapak	misuh
@zaujah_furqon aq jg 3x nyoba yg 2 dibatalin trus . Tp yg ke 3 bisa di bayar ststus nya bis itu mlm baru di cairin .	lainnya
@dewinm01 Uda AQ coba tapi GK bisa gagal muluk... Padahal internet saya lancar pake wifii Indi**e dirumah..	lainnya
cuma sekedar pemahaman, ada 2 devisi berbeda dan ada 2 program serbu seru berbeda, BL reguler dan BL mitra, untuk BL reguler buat umum dan BL mitra khusus barang serbuannya sudah berbeda syarat dan ketentuan sudah berbeda, jadi jangan disamakan, masak ya belum paham, kalau belum dapat ya berarati belum rejeki,	produk
@maulana_putra85 beda devisi beda program dan beda budget kali, emang belum rejeki aja	lainnya
@d.thonny dan satu lagi mas banyak yg bilang fiktif karena mereka g dapat2, di logika aja seluruh indonesia ada berapa orang yg ikut, klo belun rejeki ya terima saja lah😂	lainnya
@zaujah_furqon di jual aja nanti jg kmbali ke buka dompet aq jg kmren gtu	produk
Yang meleset pilih emas.. uang dikembalikan ke buka emas tapi GK dikembalikan ke buka dompet... Nyesel deh tau gitu GK pilih emas... Gimana seeeeh yg saldonya nipis jadi GK bisa milih lagi....	misuh
Congratulations Pak Victor ,Bukalapak memang dihati pelanggan #BukalapakUntukIndonesia	lainnya
Blum dapet juga huhu :( masih berharap di hari hari berikut nya :(	lainnya
@rizqysensei pengn bngt stroller bayi pdahal wt ank gw.. eeh.. Mleseet lgi.. 😪😂😅	lainnya
Alhamdulillah memang sudah rezeki @debyoctamonica	lainnya
@d.thonny awalnya ikut serbu emas dan kemudian batalkan transaksi itu setelah baca ulang klausal BL.	misuh
@ilhami_kaenjin spertinya hanya fiktif belaka.. Percuma.. Qt kaya nungguin telor ayam netas jadi dinosaurus	misuh
@d.thonny tul	lainnya
@robincandra syediih.. Cba lebih transparan ya, pdhal hdiah gausah yg mahal² asal brmanfaat, org psti bnyk yg minat,  klo lbih trnsparan insaalloh lbih berkah. Tiap hari 20 item w serbu tdk satupun yg nyantol. 😌😂	misuh
Ohh,jadi yg menang mitra buka lapak ya,kalau cuma customer bisa gak menang??soalnya saya gak pernah menang,dari zaman masih minicoper sampai rumah 1 M🤣🤣meleset maning...	lainnya
Semoga saya yg terpilih  selanjutnya	lainnya
Mudah2an bisa menang	lainnya
Dr awal sampe sekarang blm dapat sama sekali . bener ga sih ..	misuh
@ilhami_kaenjin haha jelas bos , mereka tuh muterin uang konsumen dlu yg bnyk nya seindonesia gini, mana mungkin mereka kasih dgn cuma" , dpt pun pasti nunggu seabad 😂	misuh
Gw mending ikut yg lain aja dah dripada refund saldonya lama lumayan buat ngikut 1 slot kan bisa zzzz	misuh
hai @bukalapak , aku bukan "ZharBorneo" tapi aku cuman pengen komen jadi yang pertama doang kok, hehehe, jangan lupa cek akun aku ya	lainnya
Banyak yang kompalin refund serbu seru item emas , brarti pas nyerbunya ngga baca syarat dan ketentuannya ,coba pada di cek di bukaemas ,yang belum tau dananya  balik ke bukaemas,yang belum balik  ditunggu aja sabar ,nanti juga dibalikin itu kan ada tulisan antara 1×24 sampe 2×24 JAM	produk
yg cuma customer ap ada kesempatan menang ? @bukalapak	produk
@bukalapak #SERBUSERU.. SERBUnya =Dapet?? SERUnya=Gak dapet2!!😭😭 #malamserbuanke804	lainnya
Min tiap x ikutan promo Gk pernah kepilih meleset trus min. 😂😂	lainnya
Apakah yang dapat itu mitra buka lapak aja ya,,?	produk
@adottckl ngopi dulu mas	lainnya
@rizqysensei sama,apa ini cma viktif?	produk
Wis ora minat melu serbu seru	misuh
Oh jd hrs gabung mitra ya , 9 brg serbuan saya lewat semua😎	produk
Khusus mitra bukalapak yg tdk meleset... 😀😀 @bukalapak  Sebagian umum pasti meleset,  Uda setingan @bukalapak  #serbuserumitrabukalapak	misuh
Wah hari ini ada emas lagi, mantul bener nih Bukalapak👏	lainnya
yang dapet nmax kmaren siapa?	lainnya
😂😂	lainnya
@bukalapak gw bantuin jawab konsumen² lu yg pada protes 😂	lainnya
@rahim95487 itu serbuseru khusus mitra bukalapak... beda ama serbuseru buat umum.. 😪😪😪	produk
Kapan aku dapat serbuan min	lainnya
@pudjie_hdk maklum, yg nyerbu se Indonesia..	lainnya
Berarti benarkan yg menang kebanyakan mitra bukalapak	misuh
Wuayaaahhhh,,, akankah berakhir indah, melesettt... 😆 😆 😆	lainnya
Gk pernah menang... Uang gk kembali.	misuh
☝️☝️☝️	lainnya
Tuh kn pd komplen ,ngaririweuh wae atuh min mneh mah ,ngges weh blik ka buka dompet ,derr kanu bukagoldeng ,lieur rr ..	lainnya
Agar dapat terpilih gimana ya,	lainnya
Zonk terus ey @bukalapak #BukalapakUntukIndonesia	lainnya
Amiinnnn 🙏🙇	lainnya
Rasa2nya sebagian besar Mitra Bukalapak	lainnya
Besok ada bukareksadana	lainnya
😄	lainnya
Gw tiap hari ikut... ngapa gk dapet2 yak...	lainnya
Awas Bukalapak mulai buat program yang menyesatkan....hati2....	misuh
Hahaha.. Ga pernah dapet sdh 3 bulan..😂😂😂 Well good	lainnya
Semoga yg ku semogakan tersemogakan😇🙏🏻	lainnya
11 lebih 20detik... pemilih sudah +999 hebat👍👍👍camera sony	lainnya
👏👏	lainnya
Semoga selanjutnya saya yang beruntung, aamiin	lainnya
masya Allah .. semoga saya seberuntung beliau	lainnya
Bismillah jawabanya 1.logo gambar warna atas dan bawah beda 2. Warna garis luar nike atas dan bawah 3.sama lubang tali sepatu nya beda @irsyadmaulana88 @apriliaptr_4 #bukakuis #bukalapakuntukindonesia semoga menang amiinn	lainnya
Jawaban dari perbandingan gambar diatas adalah:  1. Warna garis luar logo sepatu nike berbeda warna 2. Lubang tali sepatu pada gambar di atas dan bawah berbeda yang di atas ada lubang berisi besi dan bawah tidak 3. Logo pada gambar di atas berbeda posisinya  180° @herryfiansyah @nawatraigus #bukakuis #bukalapakuntukindonesia	lainnya
1.sepatu diatas ada ringbya yg dbwah gk ada.. 2. Warna logo list putihnya berbeda atas bawah. 3. List logo nike gradasi warna berbeda antra atas bawah @humairoh.albantani @hildanoor  #BukaKuis #bukalapakuntukindonesia	lainnya
@rhonyesuzuran @madridancha93 #BukaKuis #BukalapakUntukIndonesia 1. Garis luar logo Nike berbeda warna 2. Logo berwarna merah yg atas ada sdikit warna putih 3. Ring pada lubang tali sepatu bagian atas.	lainnya
1. Lubang tali sepatu berbeda 2. Logo gambar warna merah pd sepatu berbeda 3. Warna garis luar logo nike pada kedua sepatu berbeda @tari_momvale @bowsatriani88 #BukaKuis #BukalapakUntukIndonesia	lainnya
1 lubang tali sepatu berbeda  2 logo gambar warna merahnya sepatu atas Dan bawah berbeda posisi 3 garis nike nya beda warna. @dwiyanmhady0024 @dweno27 @irfan_nasrul30 #bukalapakuntukindonesia #bukakuis	lainnya
Mnurut sya prbedaanya : outline logo nike, background, logo gambar warna merah beda posisi <enter> @abdullahasmara @laodefikri  #BukaKuis #bukalapakuntukindonesia	lainnya
1. Ukuran lubang tali sepatu; 2. Logo Wings Air Jordan terbalik; 3. Gradasi warna berbeda pada bagian terluar logo centang Nike. @ymesrayani02 @rian_arenda #bukakuis #bukalapakuntukindonesia	lainnya
@bukalapak jawabannya adalah: 1. Lubang tali sepatu atas berbeda dengan sepatu yang bawah. 2. Arah logo warna merah berbeda sepatu atas dan bawah. 3. Warna garis luar logo Nike berbeda sepatu atas dan bawah. #bukakuis #bukalapakuntukindoesia	lainnya
Hallo admin @bukalapak Jawabannya adalah :  <enter> 1. Lubang Tali Sepatu  <enter> 2. Warna Garis Tepi Logo Nike  <enter> 3. Logo Air Jordannya Posisinya berbeda gradasi dan warnanya.  <enter> #BukalapakUntukIndonesia  <enter> #BukaKuis  <enter> Yuk Ikutan Kawan Kawan : <enter> 1. @fitri_nuraini24 <enter> 2. @wahyunursyahara <enter> 3. @nurhalizahanggi <enter> 4. @nursyamsiahharahap <enter> 5. @limahnst <enter> ••••• <enter> ⏺️Fb : Rapi Mahenra Harahap <enter> ⏺️Tw : @Rapiharahap <enter> ⏺️IG : @Rapiharahap <enter> ••••• <enter> ● Done Like dan Follow Sosial Medianya. ● Done Berikan jawaban saya. ● Done Mention teman saya untuk ikutan. ● Done Cantumkan Hastaghnya. ● Bismillah...	lainnya
Hallo admin @bukalapak Jawabannya adalah :  <enter> 1. Lubang Tali Sepatu  <enter> 2. Warna Garis Tepi Logo Nike  <enter> 3. Logo Air Jordannya Posisinya berbeda gradasi dan warnanya.  <enter> #BukalapakUntukIndonesia  <enter> #BukaKuis  <enter> Yuk Ikutan Kawan Kawan : <enter> 1. @fitri_nuraini24 <enter> 2. @wahyunursyahara <enter> 3. @nurhalizahanggi <enter> 4. @nursyamsiahharahap <enter> 5. @limahnst <enter> ••••• <enter> ⏺️Fb : Rapi Mahenra Harahap <enter> ⏺️Tw : @Rapiharahap <enter> ⏺️IG : @Rapiharahap <enter> ••••• <enter> ● Done Like dan Follow Sosial Medianya. ● Done Berikan jawaban saya. ● Done Mention teman saya untuk ikutan. ● Done Cantumkan Hastaghnya. ● Bismillah...	lainnya
1️⃣ Outline logo NIKE atas ORANGE, yang bawah MERAH <enter> 2️⃣ LOGO Air Jordan terbalik <enter> 3️⃣ Gambar sepatu bawah TIDAK ADA RING LUBANG tali sepatu <enter> #BukaKuis #BukalapakUntukIndonesia @fcornelio16fc @rizkygustian999🙏🏻	lainnya
1️⃣ Outline logo NIKE atas ORANGE, yang bawah MERAH <enter> 2️⃣ LOGO Air Jordan terbalik <enter> 3️⃣ Gambar sepatu bawah TIDAK ADA RING LUBANG tali sepatu <enter> #BukaKuis #BukalapakUntukIndonesia @fcornelio16fc @rizkygustian999	lainnya
1. Lubang tali; 2. Logo gambar; 3. Warna garis luar logo #bukakuis #bukalapakuntukindonesia @kaagirsang @herowijaya	lainnya
Cari  sesuai  kebutuhan  tetap  primer	lainnya
Bismillah.  1. Lubang tali sepatu  <enter> 2. Warna garis luar Logo Nike  <enter> 3. Logo gambar warna merah  <enter> @dianrachmad91 @dindahw @yuanitachrist <enter> #bukalapakuntukindonesia	lainnya
Admin @bukalapak ... Kembalikan dong dana dari buka emas ke buka dompet....! Jangan akal-akalan lah....?	misuh
1.Lubang tali satu ada besi dan satu biasa 2. Garis di luar lambang nike berbeda warna 3. Lambang di atas lambang nike berbeda posisi bentuk . @joerifskti @antonio_febrianto #bukakuis #bukalapakuntukindonesia	lainnya
@didikhamdan sip dah untung ada kendala teknis😂	lainnya
@aart.dsilence tenaang. Tim support bukalapak cukup responsif. Tadi saya nanya, dan katanya memang sedang ada kendala teknis untuk pengembalian. Sabar aja, nanti juga uangnya balik. Untuk yg serbuseru emas emang bakal tetep jadi saldo emas. Positif wes. Kebanyakan ngeluh juga hasilnya sama. Sabar yaa	produk
@didikhamdan iya kalau menang...low gk dapet ini masuknya ke Bukaemas bukan ke dompet...berarti nabung buat beli emas	produk
Jawabannya adalah : 1. Lubang tali sepatu atas dan bawah berbeda. 2. Logo gambar berwarna merah juga berbeda. 3. Warna garis luar logo Nike pada sepatu juga berbeda. 4. Warna baground pada masing2 sepatu juga berbeda. @ernijanata @nurulromsah #BukaKuis #BukalapakUntukIndonesia	lainnya
Lubang tali sepatu atas dan bawah berbeda . Logo gambar pada warna merah sepatu atas dan bawah berbeda posisi . Warna garis luar sepatu Nike atas dan bawah juga berbeda @yuueen @dinianamtar #BukaKuis #BukaLapakUntukIndonesia	lainnya
1. Warna putih pada logo air jordan  <enter> 2. Ring pada sepatu bagian atas  <enter> 3. Warna garis tepi di logo nike  <enter> #BukaKuis #BukalapakUntukIndonesia  <enter> @azunyanbdg @boniebilly	lainnya
<enter> buat aku	lainnya
1. Warna putih pada logo air jordan  <enter> 2. Ring pada sepatu bagian atas  <enter> 3. Warna garis tepi di logo nike  <enter> #BukaKuis #BukalapakUntukIndonesia  <enter> @azunyanbdg @boniebilly	lainnya
1. Warna putih pada logo air jordan  <enter> 2. Ring pada sepatu bagian atas  <enter> 3. Warna garis tepi di logo nike  <enter> #BukaKuis #BukalapakUntukIndonesia  <enter> @azunyanbdg @boniebilly	lainnya
Haiii haii @bukalapak Ada 3 perbedaan nih <enter> 1. WARNA GARIS LUAR LOGO NIKE PADA SEPATU ATAS DAN BAWSH BERBEDA  <enter> 2. LUBANG TALI SEPATU ATAS DAN BAWAH BERBEDA  <enter> 3. LOGO AIR JORDAN NYA POSISI NYA BEDA GRADASI DAN WARNA NYA. <enter> Kalau ada sumur diladang boleh kita menumpang mandi ? Kalo ada yang lagi give away boleh kali dibagi bagi.😁 kuy gaes ikutan juga @ibnutaqim_ @fatkhurohman766 #BukaKuis #BukalapakUntukIndonesia semoga sadjaaa🔥🔥	lainnya
Ada 3 perbedaan 1. WARNA GARIS LUAR LOGO NIKE PADA SEPATU ATAS DAN BAWSH BERBEDA 2. LUBANG TALI SEPATU ATAS DAN BAWAH BERBEDA 3. LOGO AIR JORDAN NYA POSISI NYA BEDA GRADASI DAN WARNA NYA. Kalau ada sumur diladang boleh kita menumpang mandi ? Kalo ada yang lagi give away boleh kali dibagi bagi.😁 kuy gaes ikutan juga @ibnutaqim_ @fatkhurohman766 #BukaKuis #BukalapakUntukIndonesia semoga sadjaaa🔥🔥	lainnya
@goesti_weddingorganizer la kwe po gelem tak tukokne	lainnya
@didikhamdan di komplaine. Suruh nunggu 7hr. Ampun.	misuh
1. Logo air jordannya posisinya beda.  2. Lubang tali sepatu 3. Warna garis tepi logo ✔ nike @wandybunksu @wandy.abadi @wahd_97 #bukakuis #bukalapakuntukindonesia	lainnya
@didikhamdan yoi bro,  penipuan yg terang terangan.  Gue lebh parah. Belanja 3,5 jt katanya bakal dpt cashback 122.rb  transaksi udh selesai gk dpt juga.	misuh
@damadam482 iya mas, saya juga saldo buka emas hasil refund 12rb yg kemaren juga gak ada. Transaksinya ada, tapi saldo emasnya gak nambah. Berarti semua peserta ngalamin ini	misuh
@didikhamdan mash mendibg balik lgi ke buka emas, ini mah kagak ada sama sekali. Due udh komplaine lewat telegram. Katanya kesalahan sistem. Dan sedang di perbaiki. Tunggu sampe 2x24 jam. Gila gk tuh @bukalapak	misuh
Perbedaan nya: 1. Harganya beda 2. Engga ada bedanya 3. Engga ada bedanya #bukakuis #bukalapakuntukindonesia @rstnamara_ @rstwproductn	lainnya
hai @bukalapak Say hi dong	lainnya
Assalamualaikum min jawaban menurut saya 1. Logo gambarnya beda posisi yg atas sama bawah 2. Lubang buat tali sepatunya min beda 3. Sama warna garis nike nya. Bismillah semoga menang amiinn.. #bukakuis #bukalapakuntukindonesia @yusuf_hendriana @adesulistioo	lainnya
@aart.dsilence itu bisa dijual lagi mas	lainnya
1.Logo merah beda posisi ..2.lubang tali ..3.logo nike garis luar merah sama orange @bukalapak ikutan kuy @nia_anugerah @zhon158 #BukaKuis #BukalapakUntukIndonesia	lainnya
@damadam482 iya betul kenapa gk kembalinya ke dompet bukalapak...low ke bukaemas NGENDAP dong😫itu sama aja @bukalapak dimodalin user	misuh
1. lubang tali sepatu atas dan bawah 2. logi warna merah yang satu putihnya di awal yang satu putih diakhir 3. warna garis luar logo nike yang satu orange yang satu merah @wblestari @eskah17	lainnya
1. sepatu atas lubang sepatu pakai ring besi 1pcs, sepatu bawah tidak ada, 2. sepatu atas logo nike garis luarnya warna orange, sepatu bawah logo nike garis luarnya warna merah, 3. logo atau simbol gambar yang warna merah sepatu atas garis putihnya menghadap ke bawah, sepatu bawah garis putihnya menghadap samping kanan #BukaKuis#BukalapakUntukIndonesia @bukalapak @pepidestroyers @pur_wono13	lainnya
@bukalapak mw bukti ? Udh gw DM ke lu	servis
@bukalapak kmrin gw iku serba seru modal 50 rbu kbtulan gw gak mnang nah yg jdi prmsalahan gw knpa yg di refund cma 38rbu haa ? Yg 12rbu nya kmna ?	misuh
@bukalapak penipuan. Bca DM gw min. Mw gw bongkar kebusukan lu perihal refund dana serba seru ?	servis
@bukalapak admin,  dana balikin ke buka dompet aja,  yg ke inves emas,	produk
Jawabannya adalah 1.lobang tali sepatu 2.logo warna merah 3.garis logo nike  @puji_rianto92 @aam_riyanto #bukakuis #BukalapakUntukIndonesia	lainnya
1. logo merah 2. lubang tali sepatu 3. warna logo Nike #bukalapakuntukindonesia #BukaKuis @ndosssz @aligalendo_	lainnya
Jawabannya adalah:  <enter> 1. Garis luar logo Nike berbeda  <enter> 2. Logo merah  berbeda posisi (terbalik)  <enter> 3. Lubang tali sepatu yg atas berbeda <enter> @novanan @msulaiman89 #BukaKuis #BukalapakUntukIndonesia	lainnya
@plud_multimedia  tuku maneh kanggo aq	lainnya
perbedaan nya yg pertama di logo AIRJORDANnya nya ,yang ke2 di  list/garis luar  logo nike nya berbeda warna ,yg terahir di lubang tali sepatunya di gambar atas memiliki ring lubang sepatu sedangkan di gambar bawah tidak @iiswulansundari @kh_king_135cc #bukakuis #bukalapakuntukindonesia	lainnya
Jawabannya adalah	lainnya
Jawabanya :	lainnya
👏👏👏👏👏	lainnya
@bukalapak belom ada respon lagi min,apakah udah dicek?	servis
@yoga_astria sama nih, buka hasil refund serbu seru emas gk cair.  Dapet berapa nih @bukalapak ? Rp.12.000x ratusan ribu user.	misuh
@bukalapak tolong untuk bukalapak sudah 5 hari sejak keluhan dan komplain saya tentang akun yang dibekukan kenapa tidak ada solusi ? Cs bilang tunggu maksimal 5 harinkerja,sudah mau hari ke 5 nenapa tidak kabar??????? Saya sedang membutuhkan uang untuk berobat tidak bisa dikarenakan buka dompet saya dibekukan tanpa ada alesan jelas! Tidak ada solusi sama sekali!	misuh
1. Lobang tali sepatunya yang atas dan bawah berbeda.  2. Logo Air Jordan posisi gradasi dan warna berbeda. 3. Warna garis tepi logo Nike berbeda warna @vellaanastasya @tabahfahr85 @zahraaditya63 #bukakuiss #bukalapakuntukindonesia	lainnya
@yoga_astria Hai, perihal pengembalian Serbu Seru BukaEmas kamu, apabila kamu belum terpilih untuk serbu seru BukaEmas, maka kamu akan menerima pengembalian uang dalam bentuk saldo BukaEmas yang akan diterima dalam waktu maksimal 2x24 jam, ya.	produk
Jawabannya 1). logo Air Jordan nya terbalik posisinya... 2). warna tepi atau pinggiran logo Nike nya berbeda  atas orange bawah merah.. 3.)lobang tali sepatunya paling atas beda, yg atas ada yg bawah ga ada...@lintang_1140 @vinarockin #BukaKuis  #BukalapakUntukIndonesia	lainnya
3 perbedaannya yaitu: 1.Motif warna merah, 2.Ring lubang tali pada sepatu, 3.Warna logo Nike @march.ali @myti_ah #BukaKuis #BukalapakUntukIndonesia	lainnya
@bukalapak knp saldo saya hilang 12.000 username dayattt12345	transaksi
@didit_photography Hi, mohon maaf atas  ketidaknyamanannya, perihal kendala kamu, kami bantu via DM ya.	servis
@goesti_weddingorganizer wes duwe 2	lainnya
@bukalapak kirain uang berkurang tuh saya jadi pemenang serbuseru, boro atoh. Eh ari pek teh.. gmn donk min dr dulu ikutan terus nih serbuseru sekarang malah kecewa uang nya di refund lama udh gitu gak kebuka dompet lagi.😢	misuh
1. Lubang tali sepatu atas dan bawah berbeda 2. Logo gambar warna merah pada sepatu atas dan bawah berbeda posisi 3. Warna garis terluar logo Nike pada sepatu atas dan bawah berbeda. Ayo ramaikan kawan" @juardoparhusip @patartogatorop08 @bukalapak #BukaKuis #BukalapakUntukIndonesia	lainnya
@bukalapak balikin dong Dana nya jangan begitu caranya emang sih 12 ribu tapi kami konsumen merasa di rugikan. Di jual kembali pun tidak bisa emas nya di situ tertera emasnya. 0.02 gram dengan hrga jual 11 ribuan tapi ketika di jual tidak bisa saldo emas anda tidak cukup . Jgn begitudong @bukalapak berapa juta konsumen yang ikut berapa juta konsumen yang kecewa. Lagipun Dana buka emasnya gak bisa buat di pakai buat buka emas selanjutnya. Tolong dong kebijakan Dari perusahaan Kan rumayan uang 12 ribu bisa beli pulsa	misuh
@plud_multimedia tuku oooo	lainnya
lubang tali, logo gambar, warna garis luar sepatu nike @arumjail @mpabbinru #BukaKuis #BukalapakUntukIndonesia	lainnya
1. logo air jordan terbalik, 2. lubang tali sepatu atas ada eyelette nya yg bawah ga ada, 3 garis logo nike beda warna @akusaya233333 @nenden_ady23 #bukakuis #BukalapakUntukIndonesia	lainnya
Tolong direspon pak no tagihan BL19128FW6GMINV udah sy tf kok gak ada verifikasi malah keraluwarsa.	transaksi
Kenapa refund dana serbu sya belum dikembalikan	transaksi
Ikut serbu seru meleset mulu euy	lainnya
Min no tagihan BL19128FW6GMINV udah sy tolong segera verifikasi ya waktunya udah mepet	transaksi
@bukalapak tolong bukalapak jangan memaksa konsumen untuk investasi emas dengan cara ngadain emas harga 12rb di serbuseru,terus kalo penyerbunya ga terpilih,dananya dimasukin ke bukaemas,ini sama aja konsumen dipaksa buat investasi emas secara tidak langsung,karna saya yakin tidak semua orang yg ikut serbuseru emas itu tau kalo ga terpilih nanti dana pengembaliannya itu masuk ke bukaemas	misuh
Perbedaannya: 1.Logo Air Jondan yg Berbeda,2.Garis Loho Nike Berbeda Warna,3.Lubang Tali Sepatu juga Perbeda.@syahida_elfi @ayusaputry_ #BukaKuis #BukaLapakUntukIndonesia	lainnya
1.Lubang Tali Septatu. 2.Logo Gambar warna Merah berbeda. 3.Warna Garis Sepatu Nike Berbeda..@maemunah5113 @muhammadikhwanjr  #BukaKuis #BukalapakUntukIndonesia	lainnya
1. Outline/garis logo nike yag berbeda yg atas warna kuning, yg bawah warna merah... 2. Lubang tali sepatu pada gbr atas ada besinya wrna putih, yg gbr bawah ga ada besinya/polosan.  3. Logo merah air jordan pada gbr atas ada putih2nya dibagian bawah,sedangkan gbr bawah logonya ada putih2nya bagian atas @ochineotsu @thegodzillaz #bukakuis #bukalapakuntukindonesia	lainnya
Siang min jawaban nya adalah : 1 . Logo gambar merah pada sepatu bawah dan atas beda posisi ....2. Lubang tali sepatu bawah dan atas berbeda ....3.warna garis luar logo nike pada sepatu bawah dan atas berbeda @sandynugraha312 @mohtaupik #bukakuis #bukalapakuntukindonesia	lainnya
1.ring lobang tali atas 2.posisi logo merah 3.warna garis logo nike @aprilia5266 @jack_kece_  #bukakuis #bukalapakuntukindonesia	lainnya
@jonachristo hahaha sependapat bang	lainnya
1 Lubang sepatu atas dan bawah berbeda.  2 logo gambar warna merah pd seoatu atas dan bawah berbeda.  3 warna garis luar sepatu nike atas dan bawah berbeda #bukalapakuntukindonesia #bukakuis	lainnya
Bismilahh... Bedanya adalah 1.lubang tali sepatu beda 2.logo atas beda posisi 3.warna garis luar logo centang berbeda @sumymarwah @watialfatih #bukakuis #bukalapakuntukindonesia	lainnya
1. Hole sepatu(lubang tali) paling atas berbeda. 2. Logo Air Jordan posisinya berbeda  3. Outline pada logo Nikenya berbeda warna. @syahrul_asl161  @ali_muhyiddin  #BukaKuis #BukalapakUntukIndonesia	lainnya
1.Gambar atas pakai eyelet sedangkan gambar bawah tidak pakai <enter> 2.Gambar atas logo AirJordan dibackcounter gradasi putih kebawah sedangkan gambar bawah gradasi putih keatas <enter> 3.Gambar atas border logo Nike berwarna gold sedangkan gambar bawah warna merah <enter> @jonathan_aldi @bramyoegass #BukaKuis #BukalapakUntukIndonesia	lainnya
@bukalapak FUNGSINYA BUAT APA di dana emas, ga bs beli pulsa atau belanja jg sama aj mengendap dana segitu masak di haruskan beli emas yg 1 gr 600 rb lbh... yg ga balik ikutan kmrn umpama 1 jt org trs ga balik dananga sama aj 12 milyar mengendap di bukalapak di dana emas itu klo 1 jt org klo 10 jt org udh brp doit???? FANTASTIK yg jelas uangnya	misuh
1. Lubang tali di atas 2. Lambangnya kebalik, 3. Garis luar nike ada yg warnanya pekat dan pudar #BukaKuis #BukalapakUntukIndonesia @ilhan_azmi @apiitt_09	lainnya
#bukakuis 1 logo kebalikanya sepatu atas warna merah posisi di atas  sedangkan putihnya dibawah 2 lubang tali sepatu atas salah satunya lebih besar dari yg lain sedang yg bawah sama rata 3 warna lambang kebesaran produk Nike garis tepi sepatu atas wara oren sedangkan bawah berwarna merah @ridwanhr @baarvio_	lainnya
@bukalapak kenanya kmrn jg 12480 ga 12 rb	lainnya
@bukalapak cara buka saldo buka emas dmn	produk
(1)Lubang sepatunya berbeda, yg bawah gak ada lubangnya, (2)logo warna merah bentuk dan posisinya agak berbeda, (3) warna garis logo yg panjangnya beda. @nunik.nursaadah @nneni19 #BukaKuis #BukalapakUntukIndonesia	lainnya
@angeljehadut  @angeliajehadut Jawabanya adalah 1. lubang tali sepatu ujung di gambar satu nampak sengaja  yang di gambar ke dua ga ada 2. Warna tepi garis Nike di gambar pertama agak buram,yang kedua terang 3. Logo air jordan di gambar ke dua kebalik #bukakuis #bukalapakuntukindonesia #bukalapak	lainnya
1.warna backgroundnya 2.warna daunya berbeda warna 3.ada lubang buat tali dan satunya model tempel #BukaKuis #BukakapakUntukIndonesia	lainnya
@nurhidayati805 😂	lainnya
3 perbedaan yang ada pada AIR JORDAN 1 "A Star Is Born" diatas : 1.Lubang Tali sepatu 2.Logo Air Jordan Wings 3.Warna Stitching Luar Logo Nike @abhiprayadinoto @indriiyaani #BukaKuis #BukalapakUntukIndonesia	lainnya
@nurhidayati805 mugo2 menang	lainnya
3 Perbedaan terletak pada (1). Logo garis kecil berbeda warna yang atas orange dan yang bawah merah (2) Lubang lingkaran yang untuk memasukkan tali sepatu bagian atas berbeda (3)Logo yang berwarna merah ada putih putihnya berbeda letak warna putihnya Semoga beruntung @fia18sofia @kylanurfadilah #BukaKuis #BukalapakUntukIndonesia	lainnya
1. Lubang tali sepatu 2. Logo warna merah 3.garis logo nike @bunda_aqsha @kenur_menur #BukalapakUntukIndonesia #bukakuis	lainnya
1. Lubang tali sepatu 2. Logo warna merah 3.garis logo nike @bunda_aqsha @kenur_menur #BukalapakUntukIndonesia #bukakuis	lainnya
@bukalapak saldo saya gak balik, balikin min	transaksi
Paling ngenes tuh klo hp sering jatuh klo lg dimainin anak 😂😂 sama suka kebanting klo lg ngcas di tmpat krjaan  tali casan kgeser kursi alhasil gubraak ho jatuh 😂😂 #BukalapakUntukIndonesia	lainnya
Jatuh dijalan dan sampai sekarang gak nemuin juga 😢 #BukalapakUntukIndonesia	lainnya
B. Kedudukan | kejadian ini 3 bulan lalu,saat kita reunian disebuah cafe, hapeku kedudukan sama temanku “panggil aja Atun” sampai-sampai retak seperti hati ini iaaa retak tak menyatu 😆.. mungkin hpku gak kuat nahan beban bobotnya si atun ini. <enter> . <enter> . <enter>  <enter> Hidup harus sopan santun <enter> Jangan pandai ngebohong <enter> Hai atun  <enter> Gantiin smartphoneku dong <enter> #BukalapakUntukindonesia	lainnya
A.JATUH KELANTAI ceritanya dulu gue kan mau pergi kerumah saudara.selepas sampe kerumah saudara  hp saya ,dipinjam sama adik saya ,dan sama adik saya itu kalo mainan hp,biasanya hpnya jatuh karena adik saya itu kalo mainan game dihp itu suka marah karena kalah katanya,jadi hpnya di jatuhin kelantai deh....	lainnya
A. JATUH KE LANTAI	lainnya
banyak kecelakaan, mulai dari jatuh, kedudukan, sampe ke banting	lainnya
Pernah hp gw jatoh dari motor dan kelindes mobil, dan hancur...😢	lainnya
C. jatuh kena batu. pas pulang kerja mau ke kontrakan (jalan kaki) ternyata pas keluar kantor, mati lampu, ya udah kepakasa ngeluarin hp buat nyalain senter, tiba-tiba kesandung dan hp nya jatoh kena batu. karna buru-buru ga sempet kepikiran kondisi hp. sesampainya di kontrakan liat hp ternyata layarnya retak parah + ga pake tampered glass juga. tapi untung hp nya  strong masih bisa di pake 😄. #bukalapakuntukindonesia	lainnya
A. Jatuh ke lantai <enter> Jadi ceritanya waktu itu lagi asik nonton tv sambil main hp, cuma lebih fokus ke hp daripada tv, gak kerasa waktu berlalu sangat cepat, hingga akhirnya udah jam 11an, mata sebenarnya udah merem melek gitu, cuma tetap dipaksain nonton sama main hp, hingga akhirnya aku ketiduran saat itu di kursi bersama hp, kebetulan nontonnya sambil duduk di kursi 'malas' gitu. Gak tau kenapa tiba" kebangun sekitar jam 1an dengan posisi tv masih hidup, terus langsung keinget hp ku dimana ya, soalnya di tangan udah gak ada, pas aku liat ke bawah rupanya ada hp aku, pas aku ambil ternyata layarnya udah retak, disitu langsung muncul rasa penyesalan dalam diriku, kenapa ya tadi ak paksain tetap nonton, kenapa gak tidur aja, lagian udah ngantuk berat tadi itu. Kemudian ak langsung masuk kamar untuk lanjutin tidur. Besok paginya ak kepikiran lagi tentang hp ku yang retak tadi malam, 'padahal aku pikir selama ini udah hati" sama hp ku jangan sampe jatuh, tapi karena kecorobohanku malah jadi gini' 😢 <enter> #BukalapakUntukIndonesia	lainnya
C.lainnya ... JATUH KE ASPAL 😥 pas ulang tahun lalu dikejar kejar sm tmn" karna mau dirayain , larinya kekencengan sampe hp jatoh ga sadar😭 . Pas diambil udh retak temper glassnya sampe LCDnya jg kena 😥 .. Untungnya msh bs dipake ampe skarang hahaha #bukalapakuntukindonesia	lainnya
C.hp jatuh ga tau pas nutup mobil krak ternyata kejepit tp syukur gpp setelah itu abis mandi lupa taruh diatas celana ga taunya pas ambil kelempar dan jatuh berguling2 hingga munculah zetsu hitam dan putih AKA pecah separoh. The end.	lainnya
Kalau ak yang A : jatuh ke lantai  gara2 turun tangga ambil surat jatuh posisi hp di saku baju al hasil terjun bebas ke lantai udah deh lcd tinta hitam g bisa di pakai.nyesek banget #bukalapakuntukindonesia	lainnya
A.jatuh ke lantai karena waktu itu handphone nya baru belum ada siliconnya jadi licin sekali... Ampun tangan berkeringet ehhh handphone langsung keluar dari genggaman seketika langsung bengong karena pecah dikit sih ujungnya 😭 salahku sendiriiiiii	lainnya
D'siring banjarmasin nih👍👍👍	lainnya
Itu maskot bekantan daerah banjarmasin,wah @bukalapak mampir dibanjarmasin 👏👏👏 kalo saya pernah jatuh handphone,tapi untungnya nggak apa2,tapi kalo handphone mahal seperti samsung s6-s9 atau iphone x itu mahal harganya,jutaan,pasti hati teriris-2 #BukalapakUntukIndonesia	lainnya
Itu maskot bekantan daerah banjarmasin,wah @bukalapak mampir dibanjarmasin 👏👏👏 kalo saya pernah jatuh handphone,tapi untungnya nggak apa2,tapi kalo handphone mahal seperti samsung s6-s9 atau iphone x itu mahal harganya,jutaan,pasti hati teriris-2 #BukalapakUntukIndonesia	lainnya
C. Lainya 😁😁. Pas gua Main game Mobile legend min, lagi pushrank nih, gara gara sinyal sering maju mundur, gak seperti Syahrini maju mundur, maju mundur cantik, nah gua maju mundur maju mundur gua banting ke tembok, nyesek deh min😢😢😁😁	lainnya
#BukalapakUntukIndonesia Ketiban kipas angin @safii1717 @ashab_muslim03	lainnya
Itu iklannya sih pake hp aipon coba hp nya yg lain 😂	lainnya
Mantab harga brp tuh...	lainnya
Handphone saya dulu jatoh di jln & gak sengaja ketendang sama kaki sendiri trs hp nya nyebur ke got, sakit tapi gak berdarah😭😫 almarhum lgsg hp saya RIP👻👻👻😂 #BukalapakUntukIndonesia	lainnya
C. Lainnya,  kecemplung ke WC :( , gak perlu di ceritain lah, pedih pokonya mah :(	lainnya
Jatoh d lantai 14 gan.. alhamdulillah cuma lecet dikit. Soalnya jatoh dari meja yg juga masih dilantai 14 :'D <enter> #BukalapakUntukIndonesia	lainnya
Min testnya jatuh ke aspal..	lainnya
Jatuh ke lantai lagi dipakai mainan anak sendiri.....sampai temperred glass nya pecah tp untungnya Hp dlm kondisi baik2 saja	lainnya
pengalama ku,hp sering ganti anti gores  ya,sebab selalu pecah karna jatuh ke banting 🤣🤣,sebulan mau sampai 2 x gantik anti gores kaca nya,untung selalu pakai case,jd aman hp ny,kecuali anti gores kaca ny yg harus bulak balik di ganti 👍🏻❤️ <enter> #BukalapakUntukIndonesia	lainnya
A. Jatuh ke lantai, yang ada kerikilnya, auto retak dah 😭 #bukakuis #bukalapakuntukindonesia	lainnya
Jatuh ke lantai paling parah. Karena bikin hapeku pecah jadi 2 mangap2 gitu tapi masih bisa dipake 🤣🤣 #bukalapakuntukindonesia	lainnya
Jatuh ke lantai.. gagara dipake anak youtube an saya tinggal ke kamar mandi bentar tau tau hp nya di lempar dan lcd pecah.. #BukalapakUntukIndonesia	lainnya
A. Jatuh ke lantai.. gara gara di pake youtube an anak saya tinggal ke kama mandi tau tau udah di lantai dan layar ret	lainnya
@sashaanwar2017 lupa tag #bukalapakuntukindonesia	lainnya
C. Pengalaman saya layar hp retak bukan karena kecerobahan saya lagsung, tapi karena anak saya yang usia 2 tahun sudah ngerti buka aplikasi play vidio musik dan lain2. jadi ceritanya anak saya usia baru 2 tahun yang udah mulai main2 hp walau belum jelas mw buka apa awalnya dia sentuh2 layar hp dengan asyiknya, lama2 saya liat ko anak saya kaya kesel trus ehhh hpnya dibanting, retak lah layarnya. Ternyata pas saya liat layarnya terkunci, pantesan anak saya kesel mau play musik kayanya dia. Dan kejadian ini udah 2x min @bukalapak yg pertama saya betulin, yg ke 2 udh ga saya betulin deh terima nasib aja. Siapa tau dapet dari serbuseru @bukalapak atau dapet vocer buat betulin hp. #belanjahematdibukalapak #belanjahematbersamabukalapak	lainnya
A. Jatuh ke lantai : Itu terjadi karena kecerobohanku dalam bermain Hp .Karena pada waktu itu ,aku sedang ngantuk tapi tetap memaksakan chattingan untuk mengikuti kuis !.Akhirnya sudah tidak kuat lagi menahan ngantuk dan terjadilah Hpku jatuh ,namun seketika aku sadar dan mengambilnya kembali untuk chattingan ,dan tidak kapok !.Tapi setelah beberapa menit ,aku akhirnya berangkat tidur !.Karena sudah tidak kuat lagi menahan ngantuk berat !.Itulah cerita buruk saya dan tidak patut ditiru !😢😢😢 #BukalapakUntukIndonesia	lainnya
A. Jatuh ke lantai. Sudah sering banget saya mengalaminya..ntah apes atau apa.. yg jelas saya terkadang saya sebal sendiri kalau handphone kesenggol jatuh ke lantai.. padahal itu karna keteledoran saya sendiri.. dan saya marahi diri saya sendiri😓😌😅 semoga saya mendapatkan hidayah agar berhenti untuk teledor..sekian cerita saya yg sangat menyedihkan :") wkwk #bukalapakuntukindonesia	lainnya
Jatuh masuk k air, kronolaginya pas lagi main hp, tiba2 azan zuhur, trus buru2 mau wuduk hp nya di masukim saku kemeja batik ku, eh pas nungging hpnya jatih dan berenang gaya bebas deh. Kesel mau marah mau ngamuk, tapi ya mau ngamuk sama siapa, salah sendiri, teledor sendiri 😂😂😂😂 #bukalapakuntukindonesia	lainnya
A.Jatuh Ke Lantai <enter> jadi cerita nya gini, anak ku seneng bgt main hp. awal nya dia peragai gaya tlp2 nan, setelah lama main hp dia kesel. tiba2 aja itu hp dia banting dan hasil nya jatoh kelantai dengan kondisi batre berceceran. mau marah dia masi kecil yuda urut dada aja deh, sambil bilang jgn dbanting lagi ya nak.. #BukaLapakUntukIndonesia	lainnya
C. Lainnya, jd waktu itu pas dpet penumpang, hp ditaro disaku jaket dan ga dikancingin, abis gitu penumpang yg sblmnya ditawarin pake helm gamau pke helm dan akhirnya stelah jalan minta helm yg saya taro didpan, lalu saya ambil helm itu dan badan saya agak bungkuk eh taunya hp yg dikantong jaket tadi jatoh kejalan aspal dgn kecepatan motor kurang lebih 30km/jam, alhasil layar hp remuk #bukalapakuntukindonesia	lainnya
Lagi bercandaan sama temen gak taunya di saku ada hp dan kepukul sama gue, parahnya ternyata yang disaku itu hp gue!! #BukalapakUntukIndonesia	lainnya
@mbenkslank_custombike #bukalapakuntukindonesia	lainnya
[ C.LAlNYA ] Waktu lg mancing dilaut/pinggir pantai,pas ikanya makan tiba" respon langsung berdiri nyentak,nggak kepikiran kalo HP ditaro paha,alhasil nyemplung dh HP nya,sampe sekarang hpnya masih dlm keadaan koma tak berdaya,hahaha #bukalapak	lainnya
Diulek pake ulekan sambel , HP bengkok cekung , tempered glass pecah , tapi Hp gpp, dilurusin dikit fungsi normal hehee #BukaLapakUntukIndonesia	lainnya
C. Lainnya..(Hp terpental jatuh ke aspal) baru seminggu beli hp langsung kejadian waktu lagi keliling lingkungan KKN.. berhubung jalan di desa itu banyak yg berlubang, maka hp yang tdnya di simpan di saku motor terpental dan retak 😥 #bukalapakuntukindonesia	lainnya
A.jatuh ke lantai😢😢Sering banget hp jatuh di lantai saat hp di pinjem anak dan ga mau di lepas,di pinta malah galak di kasih balon ga mau di kasih permen ga mau efek zaman now jadi anak ngerti gadget,saya coba rayu lagi agar tidak maen hp trus krn boros paketan internet dan kasihan juga anak klau kelamaan maen hp ,tetep aja anak jaman now lbh pinter dr kancil ,bisa aja ngelesnya.dan mau ga mau deh di paksa eh malah di lempar ke TV hp nya jadi rusak smua dah tuh hp dan tv nya.mau di marahin anak sndri serba slah tetep ujung ujungnya ngelus dada juga "SABAR" anak jaman now.pesan saja untuk kalian semua agar jangan di biasakn anak maen gadget/hp ya ,cukup sy aja yg ngalamin sprti ini😢😢🎁🎁	lainnya
A. Jatuh ke lantai. Kisah hp ku saat itu sekitar Juli 2016. Saat santai di sofa, hp Lumia 730 di meja posisi di pinggir dan kesenggol, jatuh tuh hp posisi layar ke bawah. Pas diambil, loh kacanya retak. Tapi masih bisa dipakai sampai sekarang. Ya meski hanya dipakai buat simpan dan olah data office.	lainnya
C. kecelakaan yang paling parah di alamin gadget saya sih , baru aja terjadi ... lagi main hp sambil tiduran ,scroll timeline ig terus hp nya jatuh kena kepala saya ... kasian hp nya 😢 #bukalapakuntukindonesia	lainnya
C. Lainnya, Hp sony m4 saya pernah terbentur iphone 4 milik saya. Yang anehnya saat iphone saya jatuh dan membentur hp sony saya yang menggunakan anti gores malah lcd hp sony saya yang hancur berkeping-keping 😂😂 sampai akhirnya hp sony saya cuma jadi kenangan di laci sekarang 😂😂	lainnya
(C. Tergiling ke dalam mesin cuci) Di suatu pagi, di hari Rabu,  ketika saya selesai mandi dan bersiap-siap untuk berangkat ke kampus, saya menyadari bahwa dompet dan handphone saya tidak berada pada tempat biasanya.  Ternyata, di malam harinya, saya lupa mengeluarkan kedua benda tersebut dari saku celana. Pagi itu, celana tersebut dan pakaian kotor lainnya sudah masuk ke dalam mesin cuci. Keduanya sudah basah terendam air. Isi dompet masih kering karena terlindung, sementara handphone saya sudah terendam air. Ketika diangkat, handphone sudah mati. <enter> Setelah dikeringkan, saya coba mengaktifkannya di sore hari sepulang dari kampus. Layarnya hidup, tapi hanya bisa melihat menu, tak ada sinyal. Tak bisa menerima atau pun menelpon. Tamat sudah riwayat handphone saya. Begitu pikir saya. <enter> Selama dua hari handphone saya tidak menyala. Saya sempat berpikir, mungkin sudah waktunya handphone tersebut diganti dengan yang baru <enter> Namun di hari ketiga, ketika saya coba mengaktifkan kembali, ternyata handphone tersebut bisa berfungsi kembali. Ia bangkit dari mati surinya. Alhamdulillah😂😂😂 #BukalapakUntukIndonesia	lainnya
(C. Tergiling ke dalam mesin cuci) Di suatu pagi, ketika saya selesai mandi dan bersiap-siap untuk berangkat ke kampus, saya menyadari bahwa dompet dan handphone saya tidak berada pada tempat biasanya. Ternyata, di malam harinya, saya lupa mengeluarkan kedua benda tersebut dari saku celana. Pagi itu, celana tersebut dan pakaian kotor lainnya sudah masuk ke dalam mesin cuci. Keduanya sudah basah terendam air. Isi dompet masih kering karena terlindung, sementara handphone saya sudah terendam air. Ketika diangkat, handphone sudah mati. <enter> Setelah dikeringkan, saya coba mengaktifkannya di sore hari sepulang dari kampus. Layarnya hidup, tapi hanya bisa melihat menu, tak ada sinyal. Tak bisa menerima atau pun menelpon. Tamat sudah riwayat handphone saya. Begitu pikir saya. <enter> Selama dua hari handphone saya tidak menyala. Saya sempat berpikir, mungkin sudah waktunya handphone tersebut diganti dengan yang baru <enter> Namun di hari ketiga, ketika saya coba mengaktifkan kembali, ternyata handphone tersebut bisa berfungsi kembali. Ia bangkit dari mati surinya. Alhamdulillah😂😂😂	lainnya
Awalnya terjadi karena ledakan besar di ruang hampa milyaran tahun lalu. ...... Eits kejauhan... Berawal ketika handphone yang ku beli ketika susah payahnya ngumpulin uang saku ketika masih SMA, you know lahh PELAJAR. Teman ku meminjam nya, saat itu handphone ku memakai Ring Holder, karena lagi trend. Dia menyematkan ring holder itu di jari nya. Dia putar2 beserta handphone nya. Well, mungkin dia anggap itu baling2 bambu. Ring nya lepas, Smartphone yang ku beli susah payahnya jatuh ke Lantai, dan seketika retak semua LCD nya. Btw, jatohnya tengkurap, posisi touchscreen di berhadapan dengan lantai. 😔 Sebetulnya aku malas menceritakan hal ini, karena aku sudah mengikhlaskan nya. Semoga saja kebaikan dari Tuhan yang membalasnya. Jadi jawabannya Adalah A. JATUH KE LANTAI #BukalapakUntukIndonesia	lainnya
C. Lainnya, jatuh ke aspal pas naik motor, langsung mati total camera depan pecah layarnya juga pecah seribu karna kebutulan gak pake pengaman hp apapun, tadinya mau service setelah tau biayanya mahal banget bisa kebeli hp 1,  aku gak jadi service, tapi aku jual bangkai sama teman cuma laku 150rb 😅padahal belinya 4jtaan katanya sih dia jual di bukalapak #spareparthpmurah, itu hp pertama dan kecelakan hp paling tragis yg pernah aku alami #bukalapakuntukindonesia	lainnya
Pernah Kedudukan sampe layarnya retak..huhuhu pdhl cicilan belum lunas..😂😂 #BukalapakUntukIndonesia	lainnya
Semua nya udh pernah di Alamin min 😭 dari mulai jatuh ke lantai, kedudukan pas di dlm tas, kecebur air , hp hilang juga pernah 😭😭 .. Btw aku sering banget beli di Bukalapak.. nahh, barusan beli coklat yang sering aku beli. Ternyata stock coklatnya habis.. terus yaaa aku batalkan pesanan dong ya... habis itu uang yang seharusnya untuk coklat td, jadi cair Ke DANA.. masalahnya nomer HP ku ganti... kartu hilang 😭 trus gmn yaaa min solusi nya.. aku tetep mau beli coklat itu di Bukalapak.. dan tetep harus verifikasi pake nomer yg ada di DANA .. aku ikut kuis sekalian minta solusi nihh.. thx u @bukalapak #BukalapakUntukIndonesia	lainnya
Wah kalo masalah gadget udah sering banget kecelakaan, mulai dari sering jatuh yg ringan, sampe yang paling parah pernah pada waktu itu sedang bawa motor sambil denger lagu pake headset dan gadget ditaruh di kantong motor bagian stang. Pas ngebut hapenya jatuh dan ketinggalan jauh, dan udah mau kelindes mobil hahaha😂😂 #BukalapakUntukIndonesia @bukalapak	lainnya
Wah kalo masalah gadget udah sering banget kecelakaan, mulai dari sering jatuh yg ringan, sampe yang paling parah pernah pada waktu itu sedang bawa motor sambil denger lagu pake headset dan gadget ditaruh di kantong motor bagian stang. Pas ngebut hapenya jatuh dan ketinggalan jauh, dan udah mau kelindes mobil hahaha😂😂 #BukalapakUntukIndonesia @bukalapak	lainnya
💙 @bukalapak	lainnya
Wah kalo masalah gadget udah sering banget kecelakaan, mulai dari sering jatuh yg ringan, sampe yang paling parah pernah pada waktu itu sedang bawa motor sambil denger lagu pake headset dan gadget ditaruh di kantong motor bagian stang. Pas ngebut hapenya jatuh dan ketinggalan jauh, dan udah mau kelindes mobil hahaha😂😂 #BukalapakUntukIndonesia @bukalapak	lainnya
Wah kalo masalah gadget udah sering banget kecelakaan, mulai dari sering jatuh yg ringan, sampe yang paling parah pernah pada waktu itu sedang bawa motor sambil denger lagu pake headset dan gadget ditaruh di kantong motor bagian stang. Pas ngebut hapenya jatuh dan ketinggalan jauh, dan udah mau kelindes mobil hahaha😂😂 #BukalapakUntukIndonesia @bukalapak	lainnya
Saya pernah pas waktu saya ketika maen PUBG tiba-tiba di depan ada semacam lobang dan hp saya terbelentang ke tengah jalan,pas saya ambil Kaca nya retak 17Helai😢 Saya disitu merasa rugi demi maen PUBG sampe gak liat jalan sama sekali, hasilnya hp ke banting dan sekarang saya udah gak maen PUBG lagi karna saya takut terulang kejadiiannya lagi..	lainnya
A. Jatuh ke lantai. Waktu itu abis isya sekitar jam 8 malemanlah, pas jamannya COC itu saya lagi WAR ke 2 diteras depan rumah, tiba2 ada yg jatoh dari atas genteng ke leher bagian belakang saya (main game sambil bungkuk) seketika saya pegang ternyata ULAT KEDONDONG (itu loh min yg gede itu lebat bulunya, bulunya yg udah nempel dileher susah dicabut alhasil dikerok nih leher pake pisau yg udah dilumurin minyak goreng) kan reflek tuh HP dilempar jadinya, udahmah hp udah retak disudut kanan atas layar ditambah kejadian ini jadi double retaknya melintang dari kiri bawah ke kanan atas dan sekarang rusak total, udah gitu kalah lagi WARnya ditambah rekan Clan yg ngomel2, trofi menurun peringkatpun menurun, pokoknya ini tuh gegara ULAT KEDONDONG 😑😑 #BukalapakUntukIndonesia	lainnya
C. Lainnya? Jatuh dari atas genteng waktu benerin antena di rumah pas lagi rusak, eh mantan telpon jadi kaget dan terjatuh #BukaKuis #BukalapakUntukIndonesia @degeavelin @rioarya21	lainnya
B. Kedudukan 😣 .. Waktu itu gue lagi praktik elektronika di sekolahan, dan gue lupa bahwa HP nya gue taruh dalam tas😨. kebetulan waktu itu tasnya gue taruh di lantai, setelah praktik kemudian gue ambil hp itu karena penting. gue kagettt 😬 kenapa LCD nya jadi beginiii😦, dan ternyata setelah gue  telusuri ternyata sebelumnya ada yang menduduki tas gue😩. Dan hp gue rusakk tidak bisa digunakan lagi...... Dan gue beli lagi HP baru dan gue pakaikan casing spigen akhirnya hp gue yang sering ketindih dan jatuh beberapa kali tetap aman dan tidak rusak🙌😎....... Dan gue berfikirr kenapa tidak dari dulu pakai casing spigen, andaikan gue dari dulu pakai casing ini pasti hp ku yang dulu tidak rusak dan tidak usah membeli hp baru lagi😖............. @bukalapak	lainnya
@fuadirz #BukalapakUntukIndonesia	lainnya
Jatuh ke lantai, dulu pernah habis makan di warung terus mau balik reflek masukin hp ke kantong baju dam ternyata ga pas masukinnya, dan hpnya jatuh ke lantai, hpnya langsung pecah dan gabisa hidup, soalnya hpnya emang ga pake case kayak gitu. Setelah dibawa ke service lumayan juga harganya, setelah dapat hp baru langsung deh beli case yg aman meskipun mahal, daripada jatuh terus langsung rusak, mending ngeluarin uang lebih daripada hp jadi taruhannya hahaha	lainnya
B. Kedudukan .. Waktu itu gue lagi praktik elektronika di sekolahan, dan gue lupa bahwa HP nya gue taruh dalam tas. kebetulan waktu itu tasnya gue taruh di lantai, setelah praktik kemudian gue ambil hp itu karena penting. gue kagettt kenapa LCD nya jadi beginiii, dan ternyata setelah gue  telusuri ternyata sebelumnya ada yang menduduki tas gue. Dan hp gue rusakk tidak bisa digunakan lagi...... Dan gue beli lagi HP baru dan gue pakaikan casing spigen akhirnya hp gue yang sering ketindih dan jatuh beberapa kali tetap aman dan tidak rusak....... Dan gue berfikirr kenapa tidak dari dulu pakai casing spigen, andaikan gue dari dulu pakai casing ini pasti hp ku yang dulu tidak rusak dan tidak usah membeli hp baru lagi............. @bukalapak	lainnya
B.  Kedudukan.. Lupa akan kehadirannya di saku belakang membuat hancur seluruh raga... Syedih gk min? @buka Lunas juga blon aduh.. Jadi nostalgia lagi deh gwe.. Sekarang gk pernah lagi min "jangan pernah jatuh ke lobang yg sama " klo ke hati yg sama kyaknya bleh deng 😂😂😂 #bukalapakuntukindonesia	lainnya
B.kedudukan 😵 lupa dengan kehadirannya membuat hati jadi hancur min.. Syedih gk?  @bukalapak sampe bengkok min padahal lunas juga blom (ipon 6 )	lainnya
@p.r.y.s.i.a yoi	lainnya
Bukan gadget aku sih. Pernah nyenggol hp orang ga dikenal di trotoar lagi padet, jatuh terus sempet kena ban depan motor lagi maju (sempet di rem, ga kelindes 100%), awalnya pasrah"wah pasti retak nih, pecah lcdnya, kelar hidup gue harus gantiin", terus diambil tu hp, udah keringet dingin aja mikirin duit yang bakal keluar buat tanggung jawab. Pas dicek syukur lah, hp dia pake gorilla glass, case armor yang anda bumpernya+shockproof. Emang tu agak remuk di bagian gorila glass+ ujung sampe tengah casenya retak, tapi hp nya MASIH NYALA DAN SEHAT! Bersyukur banget dia preventif sama hpnya, semoga hp kamu juga 😭 #BukalapakUntukIndonesia	lainnya
Naruh hp di bagasi motor yang sudah penuh, trus ga sengaja pas nutup jok motor, nutupnya terlalu keras, masih nyantai, trus aku lanjut jalan, ga nyadar kalo hp sudah ketindihan + retak layarnya... Baru nyadar pas mau ngambil hpnya, Syock men.. untungnya aku pakai tempered glass... Namun cuma bertahan sehari, esoknya hpku mati total 😭😭😭 #BukalapakUntukIndonesia	lainnya
Jatuh kelantai pernah, kedudukam pernah , nyemplung air pernah juga😂 tpi paling parah pas jatuh kelantai sih soalnya lgsg retak seribu layarnya huhu😭	lainnya
Kecelakaan yang paling parahh itu dibanting sendiri pas keadaan emosii pas lagi berantem sama pacarr kebetulan hapenya tanpa pelindung atau cassing,  dibantingnya aja engga sadar kaya ada yang nyuruh banting banting banting😢 pas Amarahnya udah ilang liat hapenya ternyata LCD nya rusakkk sumpah nyesel pake banget kenapa hape yang engga salah apa2 jadi korban🔥🔥😭😭😭😭 #bukalapakuntukindonesia	lainnya
Dipake nonton youtube dan drama korea hampir seharian, bukannya mata yg rusak tapi malah lcd hpnya yang rusak, langsung nga-nga+bergaris-garis kayak baju tahanan 😔	lainnya
Yg paling sering jatuh ke lantai,pengalaman  yg paling sedih sudah jatuh hpnya langsung mati total,dulu paling malas pake casing hp soalnya kelihatan hp tambah tebal,sekarang selalu pake casing,,biarpun ad musibah hp jatuh,minimal mengurangi resiko hp cacat atau rusak	lainnya
Waktu itu pernah jatuh karena mau nangkep ayam peliharaan saya, kebetulan posisi hp lagi dikantong, terus pas saya lagi ngerjar ayam saya karena udah waktunya masuk kandang dan saking semangatnya buat ngejar itu ayam sampe lupa klo ada hp dikantong, Alhamdulillah ayamnya ketangkep tapi hp saya yang jadi korban karena semangat saya itu, alhasil lcdnya yang kena dan harus diganti karena ulah ayam tercinta😂	lainnya
C. Lainnya . kejadiannya hp saya dimasukkan ke gelas kopi sama keponakan yang masih batita , alhasil jadi mati total. #BukalapakUntukIndonesia	lainnya
Kalo yg parah udh 2x ngalamin. Pertama entah keinjek atau kedudukan anak2, soalnya dibawah selimut, tau2 layarnya udh pecah. Yg kedua dicemplungin ke air tetesan AC sama anak bayi hampir setengah jam lah tp Alhamdulillah hape masih bisa dipakai sampe sekarang. Kalo jatuh mah udh ga keitung apalagi punya anak balita. Kecopetan juga pernah langsung 2 sekaligus karena dalam dompet hape. Kalo suami pernah sekali, jatuh ke pembuangan air di kamar mandi toilet umum 😂 #BukaLapakUntukIndonesia	lainnya
C. Lainnya. Pernah suatu pagi usai joging maksud hati mau merebahkan diri di kasur depan TV. Eh tak tahunya istri meletakkan hape ditutupin kain jadi saya tak tahu kalau di balik kain ada hape. Spontan kain pun terinjak saya termasuk hapenya tentu. Saya kira hape bakalan baik-baik saja karena di atas kasur dan tak tahunya layar pecah jadi 2 + mati lagi! Sedih banget. Coba dibawa ke beberapa tukang servis eh ternyata tak satupun yang mampu memperbaikinya. Alasannya suku cadangnya tidak ada. Akhirnya coba browsing2 barangkali ada yang bisa memperbaiki OL eh ternyata ada tapi jauh. Terpaksa hape dikirim dulu dan menunggu semingguan kemudian baru tiba kembali di rumah. Istri terpaksa meminjam hape lama adiknya selama hape diperbaiki.  #BukalapakUntukIndonesia	lainnya
B. KEDUDUKAN.  Aku naroh hp kan biasanya di saku belakang. Kan kalau makan di pabrik itu ke kanting itu juga pada buru buru  dikarnakan ngantrinya panjang banget. Dulu pas aku lagi buru buru mau ke kantin pabrik mau makan aku sengaja lari biar antrian nya gak terlalu belakang. Pas udh ambil nasi sama lauknya.. aku cari tempat duduk.. lupa kalau hp ada di saku belakang pas duduk langsung kedenger bunyinya rek..rek...rek.. baru dari situ inget ada hp disaku belakang pas di liat lCDnya pecah parah.. jadi rasa lapernya ilang langsung gak jadi makan rasanya ngenes banget.. ngedadak kenyang. Jadi males kerjanya juga langsung ijin pulang setengah hari aja ternyata penyesalan tuh datang di akhir coba hp di taroh di saku belakng pasti gak bakalan pecah.. #BukalapakUntukIndonesia	lainnya
Pengalaman sy hp ktiban genteng pd waktu lg jemur sepatu diatas genteng, jd pas mau diangkat tuh sepatu krna cuaca mendung sy langsung buru2 ambil tuh diatas genteng pk galah bambu...eh bkannya sepatunya yg ke ambil malah gentengnya yg jtuh nibanin hp sy yg sy lg pegang #bukalapakindonesia	lainnya
min @bukalapak mohon bantuanya bisa?	servis
C. Di injek2 mantan, ancurrr dah	lainnya
Min @bukalapak kapan nih rencana ada fitur #BukaRumah ?  <enter> Bukamotor & bukamobil kan sudah ada.  <enter> Saya pengn bgt Bukalapak ada fitur #Bukarumah agar anak2 milenial seperti saya yg pengn punya bukan hanya sekedar keinginan tp terwujudkan dengan bantuan dr bukalapak.	produk
C. Nyemplung ke kolam penelitian. Alhasil lcd dan IC kena. Dibawa ke tempat service abis 1jt lebihhhh. Pdahal hara hape gasampe 2jt :( demi data penting di hape. Gapapalahhhh. Andaikan hape flexib anti air yahhh, mungkin selamattt #bukalapakuntukindonesia	lainnya
Ketumpahan kopi min..pas lg ngopi di warkop sambil nobar elclasico BARCA vs MADRID, saking snengnya Messi ngegolin ke gawang Madrid tangan saya nyenggol cangkir kopi tumpah kena Hp 😁 #BukaLapakUntukIndonesia	lainnya
@p.r.y.s.i.a ayooo...Mas @rifqi_afifuddin ikutan. Kali aja ada cerita tentang "kecelakaan" gadgetnya 😁	lainnya
(C. Lainnya). JATUH KE ASPAL DAN KENA GUYURAN HUJAN DERAS. Ceritanya, waktu itu, selepas maghrib aku dan temanku menuju pasar Pedan - Klaten untuk membeli item-item yang dibutuhkan untuk acara sekolah.  Keadaan sudah mulai gerimis. Jalanan aspal yang berlubang dan penuh genangan air karena hujan pada siang harinya. Kejadian itu terjadi ketika kami dalam perjalanan pulang. Cahaya lampu motor yang tidak begitu terang membuat kami memasuki lubang yang lumayan dalam, dan ketika itulah Gadget MEIZU tersayang jatuh. Tapi itu tidak kami sadari. Sesampainya di sekolah, kami langsung fokus menyiapkan acara untuk esok hari. Hujan lebat pun turun lagi. Pukul 11 malam dekorasi selesai dan ketika itulah ketika mau ambil Hp dengan maksud buka pesan WA, ternyata Hp nya gak ada. Aah..paling di Tas, gak ada juga. Oh..tadi ke ke kantor, mungkin di kantor, eh...gak ada juga. Aduuuh... Where is my Gadget???. Jangan-jangan jatuh pas kita masuk lobang tadi? Atau jatuh disekitar situ. Wah..kalau kelindes mobil, ancur tuh hp. Udah tadi hujan deras lagi. Sontak aku dan teman ke asrama, ambil senter dan langsung tarik gas ke lokasi jalanan lobang tadi. Disana langsung celupkan tangan kedalam lobang itu, nihil. mutar 3x bolak-balik dengen senter sana-sini. Coba sekali lagi, jalan pelan-pelan. Dan ternyata...... Thanks God, Hp nya ketemuuuu..... ya Allah...gak nyangka. Hp nya tuh pas di rerumputan pas banget di pinggir aspal, jadi gak kelindes mobil. Tapi sediiiiihhhhhh, Gadgetnya sudah terbujur kaku. Kena hujan yang hampir 1 jam. Pasrah.. ya pasrah apakah Hp ini masih bisa nyala atau tidak. Esok harinya, pas hari Minggu. Meizu-nya dibawa ke Jogja untuk diservis. Alhamdulillah.... gaesss... setelah beberapa hari Hp nya masih bagus, bisa nyala lagi. Yeaayy 😊😊😊 #BukalapakUntukIndonesia #Bukalapak	lainnya
Jatuh Ke Lantai Setelah Isi Batre Karna Buru-Buru Ada Promo Toko Online. #BukaKuis	lainnya
C. Jatuh dari sepedah motor😖 <enter> Sedikit cerita nih Sob, pegalaman pahit Gue, waktu kejadian itu kalau enggak salah sekitaran pertegahan akhir tahun kemarin 2018, Gue sedikit cerita pada malam harinya dulu sebelum Hp Gue jatuh, malam harinya itu Gue juga kena sial juga Sob,  Gue kan malamnya datang ke acara..yahhh semacam Dangdutan gitu lah, terus pas Gue pulang nih pulang dari acara dangdutan, pas di jalan, gue baru sadar Sob, ternyata Dompet Gue jatuh, entah kemana,.Gue Syok betul pada waktu itu, gue berusaha untuk cari” ternata enggak ketemu, dan pagi harinya juga gue sudah berusaha cari dan hasilnya nihi Sob, <enter> Nah pas pagi harinya itu, setelah gue berusaha cari dompet gue kesana kesini dan enggak ketemu juga, dan akhirnya Gue nyerah Sob, Gue pulang naik motor, terus pas ini nih Hp Gue jatuh, Hp Gue itu kan belakang kesingnya Gue kasih perekat ubur-ubur gitu, dan saya taruh di sepido motor waktu itu, maksud Gue taruh di sepido motor tu biar nanti kalau ada kabar televon atau apa tentang dompet Gue yang hilang, Gue langsung bisa angkat gitu Sob, nah pas dijalan pulang nih, Gue kan ngebut tuh naik sepedah, saking pegelnya dompet Gue enggak ketemu” Gue ngebut bgt tuh, pas dijalan tanjakan gitu ada gundukan tanah kalau enggak salah, Gue juga lupa kalau hp Gue, Gue taruh di sepido motor, Gue tabrak ajah tuh gundukan tanah, dan akhirnya Hp Gue jatuh Sob, jatuh! Dari sepedah, hari sial banget Gue pada waktu itu Sob, dan baterai hp gue jatuh di selokan yang ada airnya nya Sob,.apess gak kalau kaya gitu, setelah sampai rumah, gue beusaha nyalain tuh hp Gue, Gue coba beberapa kali enggak nyala tuh, Gue berusaha untuk ces hp Gue dulu, dan alhamdulilahnya kok ya masih hidup Sob hp Gue, tapinya ya gitu Sob lecet lecet semua hp gue, pokonya hari sial Gue bgt waktu itu. Udah DOMPET HILANG + hp Gue jatuh. 😥 <enter> #BukalapakUntukIndonesia @Bukalapak	lainnya
C,Jatuh ke dalam wc akhirnya matot dah hpnya sampek skrg.flexibel sobek lcd pecah btrainya langsung bengkak.#BukalapakUntukIndonesia	lainnya
kecelakaan parah HP saya yaitu mencolokkan HP pakai Kabel ke speaker aktif, lalu hape saya tiba2 mati total akibat korsleting pada speaker tsb. niat mau mendengarkan musik, malah mendengarkan ceramah istri yg marah2 gara2 HP mati total. akibat kejadian itu, saya jadi trauma mendengarkan musik kalau pkai kabel disambungkan ke speaker. mending pakai bluetooth saja menyambungkan ke speaker kalau mau memutar musik... itulah pengalaman kecelakaan HP Parah yg  saya alami. #BukalapakUntukIndonesia	lainnya
Ipin 6 ane baru aja jatuh, gara2 lepas jaket hp nya ditaruh jaket <enter>  <enter> Lcd nya pecah 😭 <enter> Hari pertama kedua normal, hari ketiga layar mulai kuning, hari ke empat lcd ngangkat, hari kelima hp mulai ngrestart <enter> H+7 hp wafat	lainnya
Jatoh ke aspal pas lagi naik motor, untungnya hape jaman dulu kuat kuat tahan banting,  ga kaya hape jaman sekarang yg gampang pecah kalo jatoh 😂	lainnya
lainnya. Saya perantau. Hidup di kontrakan kejadian baru beberapa hari yg lalu. Ketika itu saya tidur bersama teman" seperantauan (muhkrim). Kemarin saya baru beli hp dari hasil tabungan saya. Alhasil saya bahagia dpt mmbeli hp idaman saya.. setelah larut malam kami pun mulai bobok syantik dgn hp berserakan.. setelah adzan subuh tiba saya bangun dengan perasaan yg gak tau gmana jelasinya. Hp saya terletak di bawah mulut teman saya dalam keada'an basah kuyup dan berbau jigong alias KERENDEM AIR LIUR. seketika itu hp saya tarik dari bawah mulut teman saya.. ketika itu ingin berkata kasar tpi takut dosa.. saya gak tau harus gmana. singkat cerita hp saya cuci dgn deterjen  sampai bersih dan alhamdulillah sampai sekarang msih saya pake sehari hari..😊🙃😎😎😎	lainnya
A. Jatuh ke lantai...sampai gambar layarnya pecah terbagi 2 😥😥 #BukalapakUntukIndonesia	lainnya
hanphone jatuh sih biasa.. kan sudah ada pelindungnya spigen armor.. yang susah itu jatuh hati.. apalagi kalau jatuh hati ama pacar orang.. hahahaha #bukalapakuntukindonesia	lainnya
Jatuh di beton jalan, biasanya hp saia kalo jatoh dilantai tuh gakenapa2, dan pas jatoh di beton kan ada semenan yg garata trus tajem2 gitu pas jatoh disitu padahal lagi posisi duduk eh gasengaja kelepas trus kena tajem2 dibeton langsung deh retak semua anjaaiii😂😂 #bukalapakuntukindonesia	lainnya
C. Lainnya? Lagi asik ngopi, eh gak taunya si hape ku tersiram air hitam hangat yang pahit (read: kopi) mungkin pengen ngopi juga kali kayak si empunya hehe #BukaKuis #BukalapakUntukIndonesia @woodeiy @wahyuekanugroho	lainnya
C. Jatuh dari tangga ,ceritanya karena keburu-buru mau masuk kelas ngelangkah ke tangga keburu-buru alhasil kaki terpeleset dan hp yang lagi aku genggam bebarengan buku-buku jatuh ngelundung kebawah dan layar hp pecah ,hp pun mati pet gak mau nyala akhirnya tunggu nabung dulu 4 bulan (mau cerita ortu takut,maklum anak perantauan)  baru bisa beli hp baru😥😖 #BukalapakUntukIndonesia @bukalapak	lainnya
C kecemplung ke air...apesss pokonya ...niat mau foto2in @sheilaon7 eh pas  ke toilet bentar hp ku kecemplung min 😂😂pas di ambil ga nyalaaaa @Bukalapak #BukalapakUntukIndonesia	lainnya
siapa yang setuju kalo posting ini banyak like? like juga dong komentar an aku hehe 😇🇮🇩	lainnya
@ivanfauziislami itu bisa dijual, sy coba test tadi, dan itu masuk ke saldo dana bang	transaksi
Saya tidak terpilih kok uang saya ada yg kembali yaa...tgl 12 tidak kembali 12rb,tanggal 13 kemarin tidak kembali 12rb lagi..	transaksi
@umienasiroh_38 gua mh udah .2x24 jam .	servis
@kinghafizm sama saya juga belum di balikin	transaksi
@ivanfauziislami wkwkwkw untung besar dong berarti ya bg 😂, eh iya bg, abg dapat berapa saldo di bukaemas nya bg?	lainnya
@bashexecutive_ cara investasinya gmn	produk
@alventbudi saldo bukaemas gbsa dibalikin ke saldo dana. Gbisa diduitin. Musti djual , prtnyaannya emas 12 rbu siapa yg mau beli dr lapak kita?  Kl gbsa dblik2in. Lama lama lupa dan udah deh jdnya sedekah ke @bukalapak . 12000x berapa ribu/ mungkin juta org  brp tuh. 🤣	misuh
Meleset trus dari awal main serbu seru..😭😭😭	lainnya
@bashexecutive_ iyaa bg, cuman nambah saldo emas setelah dijual hanya 59 perak bg 😝	lainnya
@cartika36 sabar mas.saya juga gtu 😅	lainnya
Saya dah 2 hari..dikembalikan ke buka dompet atau kemana min..klo ke buka emas cara ngeceknya gmn ya	produk
Sy beli bukaemas kok d saldo bukaemas ga ada,yg ada hanya emas dr serbu seru	produk
@bukalapak bales dm dong ka penting	servis
@aishasibuan_ iya bener mas ternyata ada pilihan unit jualnya mau berapa	lainnya
@kuy_can iya jd si saldo dana emas yg gagal itu masuk ke buka emas, disitu jual beli emas,, krn program nya kmren buka emas , ya kayak semacam investasi emas, bs dijual, nanti masuk ke saldo dana, gitu deh kira2 bang 😅	produk
Woy dana serbu gw belum di balikin juga	transaksi
Halo @bukalapak saldo bukaemas bisa di cek di mana ya	produk
Menu buka emas ada di mana	produk
@bukalapak trus saldo buka emas nya bisa biat pembelian barang apa gk?	produk
@niadah_gea wk ashiaaap	lainnya
Kenapa dana saya makin berkurang ? sdah 2 kali saya ngikuti serbu emas katanya uang kembali 100% ? Mana uda 3 x 24 jam ni? Mhn penjelasannya..	produk
Saldo saya berkurang, g kembali seutuh ya, mohon bantuan nya terimakasih	transaksi
@alventbudi lu gk salah. Emng kita lgi di bego"in.	misuh
@bukalapak min mau nanya saya dapat notif email bahwa pembayaran saya berhasil di serbuseru dan dapat emas tp pas di buka di akun buka lapak keterangan meleset tp saldo saya sdah berkurang apakah saya jg termaauk menang?	transaksi
@bashexecutive_ apakah saldonya hanya bisa di gunakan hanya untuk pembelian emas saja ? Kenapa tibatiba jadi investasi.. pengalihan dana nih @bukalapak	produk
@job_of_suberbia coba dipilih unit nya mas,Rp.59 itu untuk 0,00001 gram kalo gak salah	produk
yg menang n-max dan mio kemarin siapa ya?kok gak ada berita nya	lainnya
Wah dari 12rb jadi 11rb di saldo buka emas hahahah ngaco dah...mana yang hari ini meleset pula...tapi kenapa pas mau di jual dananya gak 11rb ya cuma ada Rp59. Ada yang sama gak nasibnya?	misuh
Hampir putus asa😭	lainnya
Padahal.. berharap tapi rejeki g pernah berpihak pada ku. Hanoi putus asa 😭	lainnya
Kenapa semuanya masuk ke saldo buka emas...saya cek juga msh kosong...sakdo abis...mw ikutan...hrus isi saldo buka dana lagi..hadehhhh	lainnya
Udh itu susah banget mau serbu nya.mencet nya juga harus berulang". Apa semua juga ngalamin seperti itu	misuh
Engga pernah beruntung. Entah gimana cara pemilihan pemenang nya juga engga transparan. Jadi seperti kaya php. Sedih	misuh
Saldo saya dikembaliinnya hanya setengah . Saya ikutan 2. Aturan yang di dikembaliin 24000  tapi ini hanya 12 ribu @bukalapak	transaksi
saldo dlm buka emas emang balik gaess tp cairnya lama bisa sampai 1x24 jam lebih.....	transaksi
Apakah pemenang di acak atau siapa yang cepat dia yang dapat? Mohon untuk penjelasan nya	produk
@ummulkhaeryy katanya saldo berbentuk saldo emas.. Tpi saldo emas gw tatap nol.	transaksi
Pengembaliannya kok ngak smua barang.. Ada yg ngak d kembaliin. 😭	transaksi
Ngecek buka emasnya gmn sih biar tau udh masuk apa blm dana dr pmbelian yg kmrin meleset ya.	produk
@cartika36 siap kk, dan slalu siap menanti terpilih😢😅🎊	lainnya
@ullah_095 kita coba tnggu 2hari dulu gan maklum yg ikut seindonesia 😁	lainnya
@faiiiiiq sory bro gak baca s&k kalo tau mah kita gak ikut serbu	lainnya
Sy coba ikut event ini tp meleset, sedangkan saldo gk balik	transaksi
@yoga_astria klik jual selesai	lainnya
@kinghafizm cara jual emasnya gimana?	produk
@bukalapak gimana caranya buka emas ke buka dompet	produk
@fahru_muhamad sudah ada keterangannya om	lainnya
@arya_xchua Hai, kami bantu konfirmasi melalui DM, ya :)	servis
Belum balik ke saldo buka emas ya min ,masih nunggu ya, tak kira ada korupsi wkkwkw	lainnya
@duwi_c5xx emas nya di jual .	lainnya
@cartika36 sama dengan saya	lainnya
Danaku hilan 12.000.entah kmna @bukalapak	transaksi
Terus bagaimana cara mengembalikan saldo buka emas ke buka dompet	produk
Please kasih ke Gw, buat modal nikah @bukalapak	lainnya
Min saya ikut serbu seru tiga item saya ikut, terus ga terpilih tapi kenapa dananya yg di balikin cuma 2 item, yg satu lagi nelum di balikin...	transaksi
@kinghafizm Hai, perihal pengembalian Serbu Seru BukaEmas kamu, apabila kamu belum terpilih untuk serbu seru BukaEmas, maka kamu akan menerima pengembalian uang dalam bentuk saldo BukaEmas yang akan diterima dalam waktu maksimal 2x24 jam, ya.	transaksi
@bukalapak rugi dong kita bayar pake buka dana kenapa gak di refund ke buka dana aja sih?	produk
Belum di balikin .saya cek ke buka emas jg ga ada .	transaksi
@bukalapak untuk saldo Bukaemas bisa di pindahkan ke saldo yang biasa atau tidak iya atau  bisa di tarik tunai tidak iya dan kalau tidak bisa,gunanya saldo bukaemas buat apah iya ...?? @bukalapak  mohon pencerahan nya 🙏	produk
@bukalapak baik terima kasih @bukalapak atas penjelasannya	produk
@_faisalfarizi Hai, perihal pengembalian Serbu Seru BukaEmas kamu, apabila kamu belum terpilih untuk serbu seru BukaEmas, maka kamu akan menerima pengembalian uang dalam bentuk saldo BukaEmas yang akan diterima dalam waktu maksimal 2x24 jam, ya.	produk
Kenapa serbu seru emas belum di refund juga??	transaksi
@cartika36 Hai, perihal pengembalian Serbu Seru BukaEmas kamu, apabila kamu belum terpilih untuk serbu seru BukaEmas, maka kamu akan menerima pengembalian uang dalam bentuk saldo BukaEmas yang akan diterima dalam waktu maksimal 2x24 jam, ya.	produk
Apa cuma saya disini mleset tp duit ga balik, masuk ke buka emas tp saldo buka emas kosong? Tolong penjelasannya guru @bukalapak	produk
@bashexecutive_ iyaa bang, saya nunggu konfirmasi dari pihak @bukalapak 😘	lainnya
@bukalapak nah terus langkah selanjutnya gmn? ini kan udh ada detail transaksi , trus gmn lg min yg udh kita bayar?	transaksi
Meleset .... Coba lagi # pantang menyerah	lainnya
Min mo tanya klo dpt refund4% sdh cek dimenu bukaemas di transaksi, apakah emas tersebut dikirim kan ato hanya dalam saldo?	produk
nomor cutumer service  buka lapak berapa ya?	servis
@bukalapak udah min, tapi nominalnya gk 12rb ya min 😁, padahal infonya refund 12rb + Cash back 4%, mohon maaf jika kalau saya salah baca info ya min 🙏	transaksi
@alventbudi Hai, silakan kamu bisa buka fitur Bukaemas di aplikasi Bukalapak, ya. Untuk cek saldo Bukaemasnya, silakan kamu bisa klik pada "Transaksi".	produk
@vatah_black_kingdom ada kok...	lainnya
@bukalapak halaman buka emas nya kita cari di kolom search ya min?	produk
@bukalapak wah baik min, saya check dulu yaa, terimakasih sudah direspawn 🙏, saya masih awam min soal serbu12ribu	transaksi
@alventbudi Baik, silakan kamu bisa melihat saldo dari investasi BukaEmas kamu pada aplikasi Bukalapak melalui halaman BukaEmas dan di Tab Transaksi, ya.	produk
@griezzly456 jgn 3 tp 1 juta pemenang😂😂😂😂	lainnya
@niadah_gea myerbu jomblo aj mgkn ad yg nyangkut boss ku😁🙏	lainnya
@devstalo eh iya bg, cek saldo bukaemas yang bakalan di refund dimana ya?	produk
@bukalapak kira2 brp x 24 jam ya???? Min baliknya 12 rb nya	transaksi
@bukalapak terima kasih infonya mimin, gk nyangka direspawn 😂	lainnya
@bukalapak blm masuk masih 59 perak di no. 085700040001	transaksi
@alventbudi Hai, jika yang kamu maksud adalah pengembalian dana Serbu Seru untuk Emas 50gr, kami infokan pengembalian dananya akan dikembalikan dalam bentuk saldo BukaEmas dan diproses maksimal 2x24 jam kerja, ya. Silakan kamu bisa lakukan pengecekan secara berkala pada saldo BukaEmas kamu.	transaksi
@bukalapak min cek DM saya dong..😢	servis
@yantinong buka hastag #serbuseru ada banyak testi om	lainnya
Mohon bantuan nya admin buka lapak saya ikutan serbu seru tapi uang blm kembali	transaksi
Admin.. uang di bukadana hilang gak ke refund semua bagaimana?	transaksi
Cara refund Cash back bukaemas gimana yaa, abang2 dan kakak2 ada yang tau?	produk
serbu emas klo meleset uang kembali dlm bentuk saldo emas,mang sih balik tp koq saldo buka emas nya masih kosong,cuma notif doank....min..min..jawab donk...	transaksi
Saldo buka emas nya ga bisa dipake lagi buat serbu seru bisa dicairin ga? kalo ga bisa mengendap mubazir min 😞😞😞😞😞	produk
Setiap ikutan serbu Bukalapak pasti meleset terus caranya biar dapet itu  pake trik atau gmn sih kok slalu meleset Mulu #bukalapakuntukindonesia	lainnya
@resiacristy oh gitu.. baru tau	lainnya
@alvaronovariansya gan saldo bukaemas itu dimana? Karena saya mau ikut serbu seru tapi ga kembali kesaldo😢😢	produk
@sheralovato nih postingan dan caption segede gini 🤭🤭🤭😂😂😂.. wkwkwk	lainnya
ada notif pembayaran utk saldo buka emas berhasil tp koq saldo emasku masih kosong?,gimana ni admin...	transaksi
Punyaku meleset, di BukaEmas juga ga ada, gimana dong min..😢	produk
@yantinong kalau gue udah mundur,hanya sampai 500 kali saja,gak dapat apa2,yang ada saya jadi penyakit maag,jadi sering begadang 😂😂	lainnya
@gustavaofficial16 akun baru jg melese terus bos. Diboongin	lainnya
@dieanaza samaa...kok gtu ya	lainnya
@vatah_black_kingdom mungkin yg menang kaga punya IG 😂	lainnya
